change,close,date,high,long_openIntr,low,open,open_interest,pre_settle,settle,short_openIntr,turnover,volume,pre_netPosition,signal,netPosition,netchange
23,2243,20150106,2263,772200,2212,2220,862134,2217,2241,788048,2863370.81,1277816,-14612,-1,-15848,-1236
-7,2244,20150107,2269,791944,2234,2251,888732,2241,2252,802528,3037437.21,1348504,-15848,1,-10584,5264
9,2257,20150108,2265,768756,2238,2248,882012,2252,2250,797984,2571056.2,1142558,-10584,-1,-29228,-18644
-27,2230,20150109,2267,816910,2223,2257,925856,2250,2242,862786,3186766.79,1421152,-29228,0,-45876,-16648
-1,2231,20150112,2243,808116,2225,2232,904518,2242,2233,846936,1964383.58,879768,-45876,1,-38820,7056
-31,2195,20150113,2236,904918,2169,2226,981434,2233,2198,923608,2926281.4,1331602,-38820,1,-18690,20130
-58,2129,20150114,2198,961998,2126,2187,1000516,2198,2157,950114,3715924.85,1722766,-18690,1,11884,30574
26,2154,20150115,2162,927696,2110,2128,954094,2157,2140,907992,3038974.05,1419910,11884,0,19704,7820
-21,2132,20150116,2169,975262,2107,2153,1029920,2140,2133,961258,4044479.84,1895974,19704,0,14004,-5700
-30,2108,20150119,2167,801768,2061,2138,919774,2133,2118,900812,5846402.36,2760126,14004,0,-99044,-113048
-2,2108,20150120,2116,806334,2081,2110,920812,2118,2099,900600,4227853.61,2013796,-99044,1,-94266,4778
35,2141,20150121,2162,813204,2095,2106,971446,2099,2130,928848,5772235.75,2710326,-94266,-1,-115644,-21378
16,2152,20150122,2168,832678,2133,2136,995964,2130,2154,928992,3483409.86,1617230,-115644,0,-96314,19330
-31,2133,20150123,2164,886120,2115,2164,1032376,2154,2131,931390,3518985.94,1651454,-96314,1,-45270,51044
3,2128,20150126,2139,881370,2100,2125,1044194,2131,2121,934216,3541482.76,1669960,-45270,-1,-52846,-7576
14,2142,20150127,2165,834216,2121,2128,960232,2121,2144,919952,4198131.82,1958020,-52846,-1,-85736,-32890
-22,2125,20150128,2154,808804,2117,2147,948014,2144,2134,897374,3881151.78,1819114,-85736,0,-88570,-2834
1,2120,20150129,2129,823324,2108,2119,968860,2134,2116,900972,3098776.31,1464150,-88570,0,-77648,10922
14,2131,20150130,2138,808456,2113,2117,916972,2116,2127,878332,3256942.79,1531216,-77648,0,-69876,7772
-31,2099,20150202,2131,877962,2087,2130,1016280,2127,2105,909962,4312829.36,2048912,-69876,1,-32000,37876
33,2137,20150203,2146,809046,2100,2104,931860,2105,2125,867966,3911260.09,1841010,-32000,-1,-58920,-26920
12,2158,20150204,2196,724970,2131,2146,810250,2125,2163,806800,3733589.08,1725790,-58920,-1,-81830,-22910
-3,2160,20150205,2171,729260,2146,2163,812122,2163,2159,817452,3021974.78,1400000,-81830,0,-88192,-6362
4,2168,20150206,2184,731046,2161,2164,813976,2159,2172,849694,2939574.3,1353480,-88192,-1,-118648,-30456
10,2182,20150209,2183,741494,2152,2172,811744,2172,2168,852630,2689568.65,1240502,-118648,0,-111136,7512
10,2187,20150210,2202,756736,2173,2177,812872,2168,2188,857124,2947877.87,1347078,-111136,0,-100388,10748
6,2188,20150211,2194,760024,2168,2182,788192,2188,2182,861920,2544931.57,1166534,-100388,-1,-101896,-1508
3,2186,20150212,2189,750236,2174,2183,729996,2182,2183,845598,1588466.12,727658,-101896,0,-95362,6534
56,2248,20150213,2249,716794,2186,2192,746810,2183,2219,849768,3399711.01,1532026,-95362,-1,-132974,-37612
17,2261,20150216,2275,692536,2241,2244,694120,2219,2259,841072,2495049.94,1104356,-132974,-1,-148536,-15562
21,2279,20150217,2293,678132,2250,2258,659016,2259,2267,839702,1431365.5,631366,-148536,-1,-161570,-13034
-7,2298,20150225,2320,679090,2285,2305,646864,2267,2302,842460,1299288.31,564534,-161570,0,-163370,-1800
28,2323,20150226,2331,783648,2293,2295,706064,2302,2314,959492,2503771.16,1082050,-163370,-1,-175844,-12474
48,2376,20150227,2382,801628,2328,2328,693968,2314,2355,976428,4105372.88,1743496,-175844,0,-174800,1044
16,2295,20150302,2302,772608,2263,2279,716954,2257,2287,988802,2536461.45,1109052,-174800,-1,-216194,-41394
-50,2245,20150303,2305,731538,2232,2295,717064,2287,2267,956362,2533052.74,1117188,-216194,0,-224824,-8630
1,2248,20150304,2260,741926,2226,2247,731552,2267,2245,968686,1794932.85,799528,-224824,-1,-226760,-1936
-20,2219,20150305,2243,710204,2202,2239,729528,2245,2218,925006,1903793.59,858176,-226760,1,-214802,11958
-15,2201,20150306,2238,712888,2197,2216,766284,2218,2219,952016,1928552.34,869224,-214802,0,-239128,-24326
34,2238,20150309,2245,759720,2181,2204,829284,2219,2218,985276,2897122.36,1305996,-239128,0,-225556,13572
6,2238,20150310,2255,783336,2232,2232,898814,2218,2245,1013598,2979060.07,1326972,-225556,-1,-230262,-4706
60,2296,20150311,2325,937590,2214,2236,1153664,2245,2281,1171174,8510940.44,3731826,-230262,-1,-233584,-3322
22,2317,20150312,2334,1001020,2292,2295,1308258,2281,2311,1239042,7761482.15,3358374,-233584,-1,-238022,-4438
-50,2261,20150313,2332,969666,2256,2311,1322408,2311,2289,1204888,9891068.41,4320886,-238022,1,-235222,2800
-17,2238,20150316,2261,942848,2216,2255,1289148,2289,2242,1202726,6122590.73,2730750,-235222,0,-259878,-24656
-4,2242,20150317,2267,943708,2226,2246,1352232,2242,2248,1231046,5663661.19,2519030,-259878,0,-287338,-27460
-24,2210,20150318,2241,957506,2208,2234,1365306,2248,2226,1238810,4601431.83,2066958,-287338,1,-281304,6034
14,2229,20150319,2248,959120,2201,2215,1384906,2226,2228,1252694,5205959.95,2336800,-281304,-1,-293574,-12270
13,2234,20150320,2240,984774,2206,2221,1404120,2228,2223,1240644,4747630.19,2136052,-293574,0,-255870,37704
38,2273,20150323,2287,976116,2232,2235,1483566,2223,2264,1298826,6851058.37,3026586,-255870,-1,-322710,-66840
11,2288,20150324,2298,1010866,2253,2277,1573708,2264,2280,1337326,7787832.66,3415748,-322710,-1,-326460,-3750
-20,2268,20150325,2295,980788,2264,2288,1563924,2280,2279,1323970,7439743.83,3264014,-326460,0,-343182,-16722
-28,2243,20150326,2285,1004034,2241,2271,1548188,2279,2261,1284400,5621460.36,2486134,-343182,1,-280366,62816
9,2248,20150327,2249,1020588,2221,2239,1565656,2261,2236,1309612,4657976.48,2083550,-280366,-1,-289024,-8658
-10,2231,20150330,2258,1047660,2228,2241,1624372,2236,2242,1345576,5408035.11,2412568,-289024,0,-297916,-8892
3,2228,20150331,2242,1042274,2212,2225,1616478,2242,2230,1332906,5786247.49,2594546,-297916,0,-290632,7284
47,2273,20150401,2301,1032592,2221,2226,1691244,2230,2271,1411072,8696986.08,3829510,-290632,-1,-378480,-87848
-13,2257,20150402,2295,1030582,2252,2270,1682330,2271,2271,1420860,5664705.19,2494722,-378480,0,-390278,-11798
-12,2238,20150403,2256,1019922,2230,2250,1611646,2271,2242,1348146,4698414.4,2095596,-390278,1,-328224,62054
14,2237,20150407,2252,1063082,2223,2223,1672258,2242,2238,1378634,3394623.34,1516544,-328224,0,-315552,12672
2,2234,20150408,2242,1119794,2202,2232,1751128,2238,2229,1400992,4893411.51,2195730,-315552,0,-281198,34354
-67,2165,20150409,2237,1045334,2165,2232,1759304,2229,2198,1291160,6588089.01,2997358,-281198,1,-245826,35372
-29,2132,20150410,2172,1012902,2130,2161,1674206,2198,2153,1223514,6026997.56,2799228,-245826,1,-210612,35214
14,2149,20150413,2156,987874,2117,2135,1650876,2153,2139,1189222,5382779.66,2516256,-210612,0,-201348,9264
12,2162,20150414,2162,951462,2139,2150,1628284,2139,2151,1188950,4185346.53,1946128,-201348,-1,-237488,-36140
-4,2166,20150415,2185,953630,2159,2170,1615712,2151,2174,1189320,4482129.53,2062010,-237488,1,-235690,1798
-3,2160,20150416,2185,949792,2147,2163,1582972,2174,2168,1158274,6238820.91,2877446,-235690,1,-208482,27208
6,2169,20150417,2178,949150,2160,2163,1584978,2168,2170,1167814,3771207.5,1738084,-208482,-1,-218664,-10182
11,2182,20150420,2195,907882,2155,2171,1542390,2170,2176,1142530,4977878.11,2287588,-218664,-1,-234648,-15984
9,2191,20150421,2199,893140,2173,2182,1510916,2176,2186,1131000,3961174.6,1811884,-234648,-1,-237860,-3212
-14,2174,20150422,2196,903634,2166,2188,1549612,2186,2180,1178156,3548473.24,1628064,-237860,0,-274522,-36662
12,2182,20150423,2193,910820,2167,2170,1560718,2180,2181,1214842,3378788.26,1548912,-274522,-1,-304022,-29500
30,2215,20150424,2228,913590,2183,2185,1598078,2181,2209,1278086,5028599.13,2275918,-304022,-1,-364496,-60474
16,2231,20150427,2238,932554,2201,2215,1656184,2209,2218,1338420,4559341.51,2055194,-364496,-1,-405866,-41370
15,2247,20150428,2268,950884,2230,2232,1679452,2218,2253,1370444,6118109.7,2715508,-405866,-1,-419560,-13694
-28,2232,20150429,2265,939722,2217,2260,1631998,2253,2245,1361358,5153687.03,2296072,-419560,0,-421636,-2076
26,2259,20150430,2262,938312,2227,2233,1619986,2245,2249,1368424,4480422.05,1992224,-421636,-1,-430112,-8476
11,2233,20150504,2239,935600,2219,2222,1653182,2249,2230,1410924,2437159.27,1092716,-430112,-1,-475324,-45212
4,2235,20150505,2274,956606,2202,2231,1696596,2230,2242,1414406,7510575.1,3349936,-475324,0,-457800,17524
13,2250,20150506,2261,986820,2233,2237,1735404,2242,2247,1448238,5551775.32,2470282,-457800,-1,-461418,-3618
18,2266,20150507,2284,997074,2238,2248,1808384,2247,2264,1513548,9528452.22,4209296,-461418,-1,-516474,-55056
-33,2229,20150508,2272,991114,2225,2262,1742394,2264,2245,1466210,6788947.28,3024406,-516474,1,-475096,41378
15,2245,20150511,2252,975230,2229,2230,1720976,2245,2239,1451340,3933797.02,1756578,-475096,-1,-476110,-1014
-35,2205,20150512,2248,948452,2196,2240,1673658,2239,2218,1365788,5635255.66,2540988,-476110,1,-417336,58774
-1,2210,20150513,2226,981576,2190,2211,1691910,2218,2214,1401486,4537184.3,2049416,-417336,0,-419910,-2574
-40,2176,20150514,2219,1004284,2169,2216,1769046,2214,2194,1484676,5665292.42,2581696,-419910,0,-480392,-60482
-10,2168,20150515,2185,1000736,2166,2178,1781178,2194,2177,1490814,3558840.36,1634928,-480392,0,-490078,-9686
15,2183,20150518,2188,982262,2162,2168,1730378,2177,2173,1462208,3440045.36,1583182,-490078,0,-479946,10132
-24,2167,20150519,2196,983746,2165,2191,1704658,2173,2183,1451200,3446410.3,1578916,-479946,1,-467454,12492
-66,2096,20150520,2162,966798,2095,2162,1649206,2183,2129,1394410,5172983.23,2429624,-467454,1,-427612,39842
-22,2073,20150521,2101,998632,2072,2095,1734298,2129,2089,1436978,5560212.33,2661332,-427612,0,-438346,-10734
18,2088,20150522,2092,972674,2062,2070,1712008,2089,2080,1454066,4846385.67,2330318,-438346,-1,-481392,-43046
-46,2041,20150525,2092,988286,2037,2087,1742198,2080,2064,1459496,4045712.3,1959736,-481392,1,-471210,10182
1,2045,20150526,2067,984046,2039,2044,1657188,2064,2055,1443978,3668249.35,1785336,-471210,0,-459932,11278
24,2061,20150527,2079,966930,2031,2037,1623580,2055,2064,1421340,4936483.86,2391950,-459932,0,-454410,5522
13,2080,20150528,2096,900288,2065,2067,1520662,2064,2083,1336104,3986550.64,1914270,-454410,0,-435816,18594
-12,2071,20150529,2087,904920,2063,2083,1509880,2083,2075,1326220,3333522.1,1606386,-435816,1,-421300,14516
-14,2054,20150601,2083,938122,2052,2068,1575066,2075,2068,1364312,3414010.92,1651104,-421300,0,-426190,-4890
42,2098,20150602,2108,883970,2055,2056,1462864,2068,2082,1305204,5426772.97,2606380,-426190,0,-421234,4956
10,2114,20150603,2125,866180,2102,2104,1398194,2082,2115,1280972,4590866.96,2170928,-421234,0,-414792,6442
8,2116,20150604,2122,846548,2083,2108,1353798,2115,2104,1254912,5109519.2,2428588,-414792,0,-408364,6428
-12,2107,20150605,2120,852928,2096,2119,1356576,2104,2109,1264390,3942923.16,1869662,-408364,0,-411462,-3098
-15,2093,20150608,2115,874692,2087,2108,1390528,2109,2099,1268746,2856766.17,1360772,-411462,1,-394054,17408
1,2100,20150609,2109,876582,2096,2099,1391618,2099,2102,1271254,2220918.37,1056324,-394054,-1,-394672,-618
-5,2096,20150610,2115,884370,2085,2101,1384082,2102,2104,1262020,3103665.32,1475470,-394672,1,-377650,17022
-9,2097,20150611,2110,887474,2092,2106,1387316,2104,2101,1244770,2374861.98,1130180,-377650,1,-357296,20354
-53,2038,20150612,2093,919156,2027,2091,1426622,2101,2060,1293356,4342319.87,2108272,-357296,0,-374200,-16904
-33,2010,20150615,2048,925668,2000,2043,1417532,2060,2023,1300004,3466773.12,1713438,-374200,0,-374336,-136
19,2021,20150616,2028,891708,1998,2002,1368270,2023,2014,1268982,2995918.49,1487310,-374336,-1,-377274,-2938
41,2062,20150617,2076,842844,1985,2021,1265780,2014,2041,1184398,5793824.7,2838638,-377274,0,-341554,35720
-24,2039,20150618,2072,839624,2036,2063,1223604,2041,2055,1180298,3097571.08,1507054,-341554,1,-340674,880
10,2048,20150619,2074,821376,2035,2038,1179628,2055,2056,1159192,3750676.02,1824416,-340674,0,-337816,2858
-5,2091,20150623,2109,794230,2082,2096,1142726,2056,2092,1133666,2175758.57,1039880,-337816,0,-339436,-1620
-5,2080,20150624,2089,806840,2074,2085,1143792,2092,2081,1137576,2217511.84,1065786,-339436,1,-330736,8700
-11,2069,20150625,2089,804850,2064,2080,1120354,2081,2078,1137152,2096862.54,1009110,-330736,0,-332302,-1566
-8,2077,20150626,2108,784662,2057,2085,1042190,2078,2087,1044488,3771995.62,1807038,-332302,1,-259826,72476
-22,2081,20150629,2106,783950,2062,2103,1011322,2087,2086,1029224,3499618.86,1677506,-259826,1,-245274,14552
-35,2049,20150630,2095,831062,2041,2084,998262,2086,2066,1029616,3734004.34,1807040,-245274,1,-198554,46720
100,2149,20150701,2149,786382,2042,2049,875642,2066,2118,1016328,4677160.43,2207976,-198554,-1,-229946,-31392
18,2158,20150702,2158,737112,2128,2140,814580,2118,2140,945148,3843367.25,1796206,-229946,0,-208036,21910
62,2212,20150703,2220,745410,2148,2150,855038,2140,2190,894402,5087063.73,2322588,-208036,0,-148992,59044
-34,2177,20150706,2219,661856,2150,2211,714296,2190,2189,832648,4427002.16,2022846,-148992,0,-170792,-21800
54,2226,20150707,2274,683318,2161,2172,668432,2189,2231,823128,7856473.92,3520988,-170792,0,-139810,30982
-82,2141,20150708,2234,551542,2141,2223,505470,2231,2170,748720,5654434.13,2605972,-139810,0,-197178,-57368
71,2210,20150709,2290,475490,2018,2139,415750,2170,2169,678372,7453429.31,3436310,-197178,-1,-202882,-5704
29,2256,20150710,2256,549438,2224,2227,449664,2169,2243,686908,4043736.44,1802892,-202882,0,-137470,65412
10,2289,20150713,2312,596738,2226,2279,472808,2243,2277,737874,5663503.17,2487366,-137470,-1,-141136,-3666
88,2369,20150714,2369,740000,2270,2281,644918,2277,2330,776478,8713810.54,3740198,-141136,0,-36478,104658
-22,2345,20150715,2401,602060,2330,2367,508668,2330,2367,685950,8890985.64,3756768,-36478,0,-83890,-47412
20,2356,20150716,2358,601376,2277,2336,492690,2367,2315,684926,9004179.89,3889256,-83890,0,-83550,340
-79,2286,20150717,2375,534428,2259,2365,429088,2315,2310,659008,10672291.42,4619488,-83550,0,-124580,-41030
-7,2264,20150720,2300,483598,2234,2271,405926,2310,2267,589598,7703726.03,3398574,-124580,1,-106000,18580
19,2276,20150721,2302,499848,2253,2257,401836,2267,2277,624250,6022925.3,2645434,-106000,-1,-124402,-18402
43,2315,20150722,2315,512492,2260,2272,394528,2277,2286,586800,5837553.35,2554084,-124402,0,-74308,50094
9,2226,20150723,2243,534740,2197,2217,444334,2204,2221,602556,4050749.41,1823528,-74308,0,-67816,6492
-33,2187,20150724,2234,485316,2181,2220,417920,2221,2206,571306,3365960.78,1525820,-67816,0,-85990,-18174
-46,2137,20150727,2186,439962,2135,2183,406986,2206,2161,545660,2749115.06,1272440,-85990,0,-105698,-19708
18,2146,20150728,2157,423538,2115,2128,394664,2161,2138,510054,2871046.42,1342974,-105698,0,-86516,19182
-20,2134,20150729,2168,427892,2123,2154,438440,2138,2145,546126,3406514.09,1588002,-86516,0,-118234,-31718
1,2135,20150730,2157,428298,2128,2134,441468,2145,2143,566044,3241033.09,1512102,-118234,-1,-137746,-19512
-25,2122,20150731,2152,444490,2108,2147,486498,2143,2129,563872,3981985.09,1870372,-137746,1,-119382,18364
-35,2083,20150803,2131,468408,2076,2118,518070,2129,2104,612436,3492483.28,1660260,-119382,0,-144028,-24646
29,2104,20150804,2111,469018,2073,2075,524996,2104,2094,620816,3525311.19,1683502,-144028,-1,-151798,-7770
-5,2103,20150805,2121,453674,2096,2108,520152,2094,2110,602038,2960713.27,1403350,-151798,1,-148364,3434
-17,2098,20150806,2129,442082,2086,2115,519998,2110,2104,589032,2844902.14,1352050,-148364,1,-146950,1414
-21,2072,20150807,2102,437620,2045,2093,513670,2104,2074,567388,3681978.38,1775548,-146950,1,-129768,17182
47,2119,20150810,2125,386232,2066,2072,481412,2074,2101,517250,4147656.84,1974258,-129768,-1,-131018,-1250
31,2151,20150811,2183,348782,2115,2120,449116,2101,2150,455172,5353036.52,2490304,-131018,0,-106390,24628
35,2180,20150812,2182,371920,2141,2145,499034,2150,2162,451440,5276312.93,2440890,-106390,0,-79520,26870
-44,2143,20150813,2224,342060,2080,2187,475364,2162,2162,478914,7137191.8,3300644,-79520,0,-136854,-57334
-8,2135,20150814,2159,318516,2127,2143,465452,2162,2145,454354,3889985.13,1813162,-136854,1,-135838,1016
3,2133,20150817,2142,335748,2113,2130,501186,2145,2130,470088,3256851.37,1528992,-135838,0,-134340,1498
-24,2115,20150818,2148,351256,2113,2139,543416,2130,2131,491796,3396085.22,1593702,-134340,0,-140540,-6200
-20,2086,20150819,2111,371606,2064,2106,573974,2131,2081,522376,4330182.29,2080976,-140540,0,-150770,-10230
-36,2056,20150820,2096,393824,2052,2092,638604,2081,2071,569096,3630257.02,1752604,-150770,0,-175272,-24502
-10,2054,20150821,2084,391518,2048,2064,643900,2071,2062,556006,3361455.35,1629894,-175272,1,-164488,10784
-78,1979,20150824,2063,385018,1979,2057,635556,2062,2014,561656,3696813.7,1835338,-164488,0,-176638,-12150
53,1998,20150825,2026,347214,1941,1945,539620,2014,1990,488208,4387512.96,2204720,-176638,0,-140994,35644
-36,2002,20150826,2045,350502,1996,2038,572416,1990,2019,500742,3624962.66,1795718,-140994,0,-150240,-9246
47,2056,20150827,2060,342924,1997,2009,537302,2019,2026,470044,4544132.5,2242772,-150240,0,-127120,23120
-2,2054,20150828,2105,307202,2033,2056,496716,2026,2067,443674,6798261.52,3288430,-127120,0,-136472,-9352
-11,2039,20150831,2079,296682,2030,2050,476418,2067,2053,411784,5615341.23,2735724,-136472,1,-115102,21370
27,2062,20150901,2070,330566,2029,2035,498312,2053,2049,413518,4033603.74,1968354,-115102,0,-82952,32150
25,2079,20150902,2080,312072,2038,2054,449332,2049,2061,383662,3464816.99,1681184,-82952,0,-71590,11362
-57,2006,20150907,2072,319598,1999,2063,534484,2061,2025,427456,3056505.07,1509058,-71590,0,-107858,-36268
6,2015,20150908,2023,353688,2000,2009,584102,2025,2012,494302,3302737.14,1641778,-107858,-1,-140614,-32756
-10,2010,20150909,2050,400592,2007,2020,665178,2012,2025,542912,5856052.82,2892214,-140614,0,-142320,-1706
10,2025,20150910,2032,374192,2003,2015,601976,2025,2016,511704,4207833.64,2087196,-142320,0,-137512,4808
7,2022,20150911,2042,364238,2012,2015,591432,2016,2028,506926,3824118.26,1885610,-137512,-1,-142688,-5176
10,2035,20150914,2050,374072,2005,2025,584552,2028,2034,517526,4846387.38,2382874,-142688,-1,-143454,-766
11,2051,20150915,2067,401852,2035,2040,629862,2034,2053,535752,5201373.78,2534114,-143454,0,-133900,9554
16,2063,20150916,2064,364888,2035,2047,589660,2053,2050,478418,4259295.26,2077840,-133900,0,-113530,20370
-18,2042,20150917,2063,364990,2038,2060,610688,2050,2050,537706,3794691.89,1850992,-113530,0,-172716,-59186
-13,2019,20150918,2045,393050,2016,2032,685402,2050,2032,571628,3387665.09,1666984,-172716,0,-178578,-5862
3,2020,20150921,2023,379780,1978,2017,658030,2032,2002,527952,4159819.56,2077980,-178578,0,-148172,30406
-3,2014,20150922,2029,407990,2010,2017,663428,2002,2019,530814,3223750.12,1596550,-148172,1,-122824,25348
17,2022,20150923,2024,408604,2001,2005,649132,2019,2012,518680,2822570.28,1402840,-122824,0,-110076,12748
-8,2016,20150924,2035,406330,2012,2024,642030,2012,2022,533504,2424285.23,1198706,-110076,0,-127174,-17098
22,2033,20150925,2040,383188,2008,2011,601546,2022,2027,503712,2950240.58,1455254,-127174,0,-120524,6650
-33,2017,20150928,2050,342370,2012,2050,599656,2027,2023,510608,1947518.06,962616,-120524,0,-168238,-47714
-26,1989,20150929,2018,312882,1962,2015,540758,2023,1994,479136,3994162.09,2002862,-168238,1,-166254,1984
-10,1985,20150930,2003,298202,1982,1995,490874,1994,1992,431876,1934744.05,971498,-166254,1,-133674,32580
-36,1969,20151008,2006,333952,1969,2005,563114,1992,1984,459364,1595182.06,803942,-133674,1,-125412,8262
0,1970,20151009,1988,361560,1962,1970,624260,1984,1975,500442,3404759.53,1723964,-125412,0,-138882,-13470
22,2000,20151012,2007,370234,1971,1978,624012,1975,1989,507904,3833888.37,1927894,-138882,0,-137670,1212
5,2005,20151013,2015,391100,1986,2000,652346,1989,1998,529734,2780231.25,1391220,-137670,-1,-138634,-964
4,2012,20151014,2028,384380,2003,2008,630034,1998,2016,537640,3046115.06,1510690,-138634,-1,-153260,-14626
-5,2013,20151015,2021,406256,2006,2018,632364,2016,2014,546474,1863446.17,925340,-153260,1,-140218,13042
-22,1987,20151016,2012,429128,1983,2009,686576,2014,2001,582950,2279226.6,1139202,-140218,0,-153822,-13604
-13,1969,20151019,1987,431164,1966,1982,723970,2001,1977,595528,2097828.87,1061376,-153822,0,-164364,-10542
-19,1952,20151020,1973,476816,1934,1971,781652,1977,1957,655818,3055726.49,1561592,-164364,0,-179002,-14638
-17,1943,20151021,1964,489694,1927,1960,804838,1957,1944,679256,3574577.98,1838322,-179002,0,-189562,-10560
18,1961,20151022,1964,469362,1937,1943,744684,1944,1951,640940,2120810.72,1087174,-189562,0,-171578,17984
-14,1950,20151023,1967,487024,1931,1964,718438,1951,1947,636350,3144738.03,1615236,-171578,1,-149326,22252
9,1963,20151026,1967,460522,1943,1954,685840,1947,1955,586934,2349318.42,1201606,-149326,0,-126412,22914
2,1964,20151027,1972,468196,1939,1962,661528,1955,1955,564374,2289110.52,1170978,-126412,0,-96178,30234
3,1970,20151028,1977,462254,1962,1967,652398,1955,1969,556566,1936700.81,983432,-96178,0,-94312,1866
-3,1966,20151029,1971,469168,1953,1969,655066,1969,1961,551224,1841307.36,938910,-94312,1,-82056,12256
-14,1949,20151030,1969,458502,1944,1963,645118,1961,1958,565672,1784642.4,911678,-82056,0,-107170,-25114
-3,1950,20151102,1959,479770,1941,1953,665708,1958,1951,573934,1379778.88,707262,-107170,1,-94164,13006
-5,1945,20151103,1954,476916,1932,1950,637552,1951,1942,573286,1713396.03,882310,-94164,0,-96370,-2206
25,1967,20151104,1968,461692,1941,1942,598948,1942,1957,544890,1413625.39,722458,-96370,0,-83198,13172
2,1967,20151105,1975,451370,1957,1965,578764,1957,1966,524374,1478711.13,752190,-83198,0,-73004,10194
-1,1969,20151106,1972,432868,1950,1970,566070,1966,1959,521496,1673161.45,854024,-73004,0,-88628,-15624
18,1986,20151109,1999,379690,1960,1968,519370,1959,1981,498072,1442118.63,727926,-88628,-1,-118382,-29754
-33,1952,20151110,1987,352184,1950,1985,510512,1981,1966,489864,1410085.64,717108,-118382,0,-137680,-19298
-17,1932,20151111,1952,346454,1929,1949,525892,1966,1941,479278,1897524.3,977408,-137680,1,-132824,4856
-6,1922,20151112,1940,373618,1908,1928,581924,1941,1924,506162,1894982.69,984838,-132824,1,-132544,280
-7,1908,20151113,1934,388632,1907,1915,579844,1924,1921,532102,1254414.29,652850,-132544,0,-143470,-10926
-44,1862,20151116,1909,393102,1860,1906,611364,1921,1886,532640,1940763.49,1029102,-143470,1,-139538,3932
-12,1852,20151117,1872,398880,1851,1864,622876,1886,1862,542710,1634918.14,877864,-139538,0,-143830,-4292
-31,1823,20151118,1865,436696,1819,1854,641990,1862,1840,564030,1957497.7,1063738,-143830,1,-127334,16496
-51,1779,20151119,1830,446320,1768,1830,587568,1840,1794,552276,3177376.18,1771172,-127334,1,-105956,21378
2,1777,20151120,1798,460936,1765,1775,546510,1794,1781,549366,1752787.25,984038,-105956,0,-88430,17526
-68,1709,20151123,1796,444332,1709,1777,507074,1781,1755,538558,2520481.62,1436572,-88430,0,-94226,-5796
55,1769,20151124,1773,400324,1699,1714,418768,1755,1731,445864,2291226.79,1323278,-94226,0,-45540,48686
13,1784,20151125,1787,373362,1751,1771,389680,1731,1771,434802,2005093.77,1132380,-45540,-1,-61440,-15900
41,1822,20151126,1840,352206,1771,1781,341108,1771,1805,388696,1905747.48,1055818,-61440,0,-36490,24950
-21,1799,20151127,1821,331344,1789,1820,316528,1805,1805,390054,1350447.21,748124,-36490,0,-58710,-22220
-41,1861,20151130,1902,356400,1829,1902,321808,1868,1854,384600,847571.45,457048,-58710,1,-28200,30510
18,1881,20151201,1898,349790,1858,1863,323680,1854,1881,376434,981959.4,521956,-28200,0,-26644,1556
7,1900,20151202,1927,344608,1883,1893,352416,1881,1895,371450,1327357.36,700566,-26644,-1,-26842,-198
-46,1852,20151203,1899,359594,1851,1898,413440,1895,1869,403928,1612428.23,862506,-26842,0,-44334,-17492
20,1870,20151204,1872,360904,1838,1850,427364,1869,1853,398604,1529074.59,824968,-44334,0,-37700,6634
14,1881,20151207,1886,367314,1857,1867,438782,1853,1873,405924,1520582.71,811986,-37700,-1,-38610,-910
-51,1824,20151208,1879,417380,1819,1875,514916,1873,1843,435828,1960637.29,1063712,-38610,1,-18448,20162
20,1842,20151209,1852,467074,1817,1822,553536,1843,1837,455876,1739828.95,947042,-18448,0,11198,29646
-2,1844,20151210,1862,470868,1835,1846,564386,1837,1845,457348,1362171.85,738226,11198,1,13520,2322
46,1888,20151211,1892,432602,1838,1842,517744,1845,1863,403046,1979148.9,1062570,13520,0,29556,16036
-2,1885,20151214,1890,420738,1867,1887,502678,1863,1880,391136,1441034.9,766534,29556,1,29602,46
14,1894,20151215,1921,404780,1873,1880,501130,1880,1900,395650,2100359.63,1105716,29602,-1,9130,-20472
5,1899,20151216,1908,441904,1878,1894,538722,1900,1894,418490,2053153.51,1084126,9130,0,23414,14284
-32,1865,20151217,1917,416664,1864,1897,555838,1894,1891,446792,2493182.47,1318662,23414,0,-30128,-53542
41,1906,20151218,1907,470684,1859,1865,568312,1891,1885,468886,2028711.39,1076426,-30128,0,1798,31926
25,1936,20151221,1941,446112,1899,1911,546054,1885,1917,455218,2440662.69,1273230,1798,-1,-9106,-10904
-5,1931,20151222,1947,436114,1923,1936,541662,1917,1934,458660,2114715.84,1093574,-9106,0,-22546,-13440
-11,1922,20151223,1934,401136,1909,1933,521480,1934,1921,444076,1716090.54,893198,-22546,0,-42940,-20394
-7,1913,20151224,1927,400634,1904,1920,520650,1921,1917,454588,1888486.14,985276,-42940,0,-53954,-11014
-11,1899,20151225,1920,420956,1896,1910,535654,1917,1907,476750,1475683.24,773746,-53954,0,-55794,-1840
-27,1869,20151228,1904,426854,1868,1896,562512,1907,1885,491008,1118381.42,593152,-55794,0,-64154,-8360
26,1896,20151229,1899,435918,1868,1870,560248,1885,1884,495962,1453743.81,771598,-64154,0,-60044,4110
17,1911,20151230,1915,456242,1893,1894,564370,1884,1904,501886,2054947.77,1079016,-60044,0,-45644,14400
9,1918,20151231,1924,443170,1903,1909,536740,1904,1914,476596,1509019.06,788266,-45644,0,-33426,12218
-41,1870,20160104,1924,418596,1866,1911,541854,1914,1891,496390,1292553.95,683492,-33426,0,-77794,-44368
15,1883,20160105,1885,422780,1854,1868,544460,1891,1871,484562,1779535.15,950922,-77794,0,-61782,16012
-11,1872,20160106,1886,448658,1859,1883,561082,1871,1873,500404,1770664.05,945564,-61782,1,-51746,10036
26,1893,20160107,1902,466304,1864,1867,560304,1873,1889,471936,2182964.29,1155884,-51746,0,-5632,46114
16,1909,20160108,1913,476464,1885,1893,575358,1889,1901,490958,1882503.46,990160,-5632,-1,-14494,-8862
-15,1895,20160111,1918,471510,1888,1910,567624,1901,1901,492668,1496863.42,787338,-14494,0,-21158,-6664
3,1898,20160112,1922,479096,1885,1895,587602,1901,1902,528780,2627692.86,1381250,-21158,-1,-49684,-28526
-12,1886,20160113,1928,536100,1877,1898,681694,1902,1901,576924,3411325.49,1794782,-49684,1,-40824,8860
20,1909,20160114,1915,550902,1878,1889,684138,1901,1898,574684,2582041.52,1360570,-40824,0,-23782,17042
1,1910,20160115,1922,534372,1903,1909,664146,1898,1912,549866,2231867.31,1167196,-23782,0,-15494,8288
72,1974,20160118,1983,562964,1900,1902,727538,1912,1945,581762,3510176.46,1804450,-15494,-1,-18798,-3304
-11,1962,20160119,1976,507478,1954,1973,671874,1945,1963,567934,2576456.49,1312468,-18798,0,-60456,-41658
1,1957,20160120,1972,539268,1944,1956,681608,1963,1958,616450,2348848.34,1199604,-60456,-1,-77182,-16726
-11,1944,20160121,1960,530856,1936,1955,656068,1958,1949,627422,2175160.23,1116288,-77182,0,-96566,-19384
20,1965,20160122,1973,538972,1943,1945,629676,1949,1959,622230,1965873.14,1003374,-96566,0,-83258,13308
-14,1954,20160125,1978,536668,1950,1968,597326,1959,1962,624768,1720550.62,876910,-83258,0,-88100,-4842
4,1959,20160126,1969,544966,1946,1955,595482,1962,1959,623316,1265257.84,645746,-88100,0,-78350,9750
2,1964,20160127,1968,532234,1949,1962,571974,1959,1957,590742,1510656.02,771944,-78350,0,-58508,19842
-2,1963,20160128,1985,526974,1956,1965,576994,1957,1970,592334,2412306.32,1224576,-58508,0,-65360,-6852
-33,1932,20160129,1965,501630,1929,1965,543544,1970,1944,575802,1844817.79,948928,-65360,0,-74172,-8812
22,1952,20160201,1961,498392,1930,1930,516298,1944,1946,552110,1294971.44,665332,-74172,0,-53718,20454
14,1962,20160202,1963,507856,1942,1948,514832,1946,1953,546646,1015756.63,520216,-53718,0,-38790,14928
-1,1958,20160203,1966,473732,1951,1959,480472,1953,1957,524688,784613.23,400924,-38790,0,-50956,-12166
-14,1945,20160204,1960,433118,1940,1959,435508,1957,1950,497570,918981.41,471340,-50956,0,-64452,-13496
-25,1921,20160205,1948,386314,1912,1946,389510,1950,1932,468930,828095.44,428712,-64452,0,-82616,-18164
-8,1893,20160215,1925,399264,1892,1901,417464,1932,1913,483740,697365.83,364630,-82616,0,-84476,-1860
18,1913,20160216,1923,467712,1893,1895,480420,1913,1912,531600,1386221.72,724918,-84476,0,-63888,20588
-14,1900,20160217,1927,477640,1897,1914,475364,1912,1912,559796,1413303.62,739154,-63888,0,-82156,-18268
4,1904,20160218,1913,486896,1895,1900,480596,1912,1905,563382,1239515.77,650750,-82156,0,-76486,5670
-7,1897,20160219,1911,514362,1880,1904,499780,1905,1896,583144,1777028.83,937312,-76486,1,-68782,7704
33,1929,20160222,1932,565378,1891,1896,519500,1896,1913,617138,1712944.47,895464,-68782,0,-51760,17022
-12,1918,20160223,1940,556106,1914,1930,506038,1913,1926,609854,1475776.97,766174,-51760,0,-53748,-1988
-35,1884,20160224,1927,540138,1882,1919,516138,1926,1902,616226,1714567.68,901272,-53748,0,-76088,-22340
-5,1880,20160225,1891,581620,1873,1885,573156,1902,1882,641034,1705643.56,906360,-76088,1,-59414,16674
-14,1870,20160226,1893,588952,1861,1884,576510,1882,1879,664928,1501513.32,799178,-59414,0,-75976,-16562
-35,1836,20160229,1884,606478,1824,1871,602462,1879,1848,692622,2057030.57,1112942,-75976,0,-86144,-10168
10,1848,20160301,1851,587304,1829,1838,580940,1848,1841,678624,1541094.27,837200,-86144,-1,-91320,-5176
5,1859,20160302,1874,598914,1848,1854,546402,1841,1861,655960,1819987.45,977998,-91320,0,-57046,34274
27,1887,20160303,1892,582204,1855,1860,511868,1861,1875,611228,1905199.27,1015976,-57046,0,-29024,28022
25,1909,20160304,1912,575602,1882,1884,492374,1875,1898,595024,1884789.07,993140,-29024,0,-19422,9602
52,1965,20160307,1974,581170,1912,1913,470460,1898,1951,609750,3420248.05,1753242,-19422,-1,-28580,-9158
-38,1927,20160308,1998,555652,1918,1965,431124,1951,1957,600052,2785725.64,1423306,-28580,0,-44400,-15820
0,1930,20160309,1947,576780,1910,1930,425884,1957,1930,629578,1499324.66,776928,-44400,0,-52798,-8398
-38,1897,20160310,1951,559116,1896,1935,403004,1930,1916,628844,1860541.22,971216,-52798,0,-69728,-16930
13,1917,20160311,1927,573558,1880,1904,419516,1916,1906,643906,818777.92,429672,-69728,-1,-70348,-620
-3,1915,20160314,1940,563072,1914,1918,438272,1906,1928,635530,692180.13,359046,-70348,0,-72458,-2110
-16,1898,20160315,1926,529654,1896,1914,445234,1928,1911,627066,897178.83,469436,-72458,0,-97412,-24954
-9,1885,20160316,1902,527002,1881,1894,456720,1911,1891,640522,676973.69,357976,-97412,0,-113520,-16108
27,1912,20160317,1914,494076,1875,1885,449096,1891,1899,608150,1054127.41,555088,-113520,-1,-114074,-554
21,1939,20160318,1948,491642,1906,1918,514806,1899,1926,633242,2306287.06,1197182,-114074,-1,-141600,-27526
-11,1926,20160321,1945,472136,1914,1937,509570,1926,1931,614774,1748127.94,905496,-141600,0,-142638,-1038
48,1975,20160322,1988,526558,1926,1927,638826,1931,1963,652896,3668594.53,1868526,-142638,0,-126338,16300
2,1977,20160323,2010,521876,1968,1975,653568,1963,1991,644902,4037614.37,2027936,-126338,0,-123026,3312
39,2009,20160324,2026,636428,1960,1970,848034,1991,1998,756514,5409457.6,2707410,-123026,0,-120086,2940
12,2012,20160325,2035,628674,1999,2000,855576,1998,2018,764480,5963025.76,2954438,-120086,-1,-135806,-15720
-25,1990,20160328,2031,631694,1986,2015,863240,2018,2011,762372,4416285.83,2196130,-135806,1,-130678,5128
-7,1981,20160329,2014,648354,1978,1988,868914,2011,1994,761752,4069815.07,2040738,-130678,1,-113398,17280
2,1984,20160330,1996,635910,1968,1982,861898,1994,1985,765348,3301138.67,1663068,-113398,-1,-129438,-16040
-47,1943,20160331,1994,557590,1938,1990,798440,1985,1964,741672,3196637.75,1627472,-129438,0,-184082,-54644
3,1946,20160401,1961,539192,1934,1943,754810,1964,1949,698040,2687029.65,1378382,-184082,0,-158848,25234
31,1971,20160405,1975,539468,1922,1940,785662,1949,1962,714254,2075814.75,1057880,-158848,-1,-174786,-15938
-12,1955,20160406,1980,526558,1948,1967,788400,1962,1963,727564,2373783.22,1209004,-174786,0,-201006,-26220
11,1961,20160407,1972,522954,1947,1950,769826,1963,1962,703044,1662120.78,847298,-201006,0,-180090,20916
-12,1952,20160408,1975,523188,1947,1964,775204,1962,1959,703738,1780496.21,908954,-180090,0,-180550,-460
28,1984,20160411,1999,531386,1956,1956,832866,1959,1977,746414,2978990.1,1506566,-180550,-1,-215028,-34478
39,2025,20160412,2026,585536,1981,1986,909370,1977,2006,781500,3570581.95,1780190,-215028,0,-195964,19064
17,2050,20160413,2083,543558,2028,2033,803462,2006,2055,691136,5144722.32,2503406,-195964,0,-147578,48386
16,2070,20160414,2098,546908,2047,2054,809924,2055,2072,694862,3806202.29,1836596,-147578,-1,-147954,-376
-3,2065,20160415,2081,551724,2056,2068,819434,2072,2068,699520,2742605.53,1326138,-147954,1,-147796,158
42,2098,20160418,2112,546844,2044,2056,805614,2068,2081,671234,3548923.38,1705114,-147796,0,-124390,23406
12,2110,20160419,2116,542738,2089,2098,820064,2081,2102,679934,3013203.7,1433626,-124390,-1,-137196,-12806
67,2185,20160420,2187,496998,2118,2118,744702,2102,2164,635530,5844519.84,2701274,-137196,-1,-138532,-1336
80,2251,20160421,2251,453344,2159,2171,704762,2164,2209,618392,3854716.39,1745276,-138532,-1,-165048,-26516
-105,2137,20160422,2296,372570,2120,2242,572176,2209,2198,534758,5101752.16,2321266,-165048,1,-162188,2860
-1,2139,20160425,2214,423714,2110,2140,642428,2198,2149,596220,5224453.56,2430788,-162188,0,-172506,-10318
38,2181,20160426,2207,403992,2131,2143,622256,2149,2172,563724,5830276.31,2683854,-172506,0,-159732,12774
2,2192,20160427,2216,417602,2156,2190,644932,2172,2188,572074,5307342.26,2425692,-159732,0,-154472,5260
-38,2160,20160428,2202,418762,2132,2198,626126,2188,2163,573838,4097689.01,1894680,-154472,0,-155076,-604
-10,2151,20160429,2209,413376,2147,2161,603460,2163,2178,577302,4474527.08,2054066,-155076,0,-163926,-8850
48,2230,20160503,2233,404468,2171,2182,603914,2178,2209,555002,3530462.82,1598176,-163926,0,-150534,13392
-32,2192,20160504,2237,397310,2164,2224,584486,2209,2199,547906,5051424.29,2297164,-150534,0,-150596,-62
32,2217,20160505,2249,446722,2179,2185,656552,2199,2221,568626,7142231.11,3215484,-150596,0,-121904,28692
-64,2176,20160506,2251,414504,2148,2240,610976,2221,2196,546380,6751612.9,3074180,-121904,0,-131876,-9972
24,2204,20160509,2224,399398,2159,2180,596856,2196,2190,508104,5857386.53,2674340,-131876,0,-108706,23170
-21,2174,20160510,2202,425436,2121,2195,613164,2190,2163,511278,6211426.18,2872132,-108706,1,-85842,22864
84,2272,20160511,2272,431414,2151,2188,653272,2163,2212,521368,4652159.81,2103536,-85842,-1,-89954,-4112
14,2300,20160512,2337,432946,2241,2286,609276,2212,2284,489306,7300715.97,3196446,-89954,0,-56360,33594
-60,2240,20160513,2316,419372,2219,2300,594944,2284,2259,500824,6704751.18,2967822,-56360,0,-81452,-25092
37,2272,20160516,2281,430730,2194,2235,599500,2259,2240,442258,6736952.67,3007292,-81452,0,-11528,69924
65,2329,20160517,2332,472070,2260,2264,667810,2240,2289,446890,5646954.24,2467054,-11528,0,25180,36708
34,2363,20160518,2404,517874,2320,2329,717514,2289,2371,494408,9474872.89,3996630,25180,-1,23466,-1714
19,2383,20160519,2391,498248,2335,2364,729678,2371,2363,517762,8759774.54,3707676,23466,-1,-19514,-42980
37,2409,20160520,2409,554410,2344,2372,805014,2363,2374,547068,8716442.58,3671050,-19514,0,7342,26856
-83,2347,20160523,2443,498146,2326,2430,741244,2374,2378,524318,9920174.48,4171576,7342,0,-26172,-33514
-92,2259,20160524,2353,480294,2259,2351,713650,2378,2301,534420,7088753.2,3080588,-26172,0,-54126,-27954
22,2253,20160525,2278,477310,2203,2231,675558,2301,2242,520192,7483837.18,3338440,-54126,0,-42882,11244
77,2346,20160526,2352,496088,2259,2269,695878,2242,2306,515086,9523052.92,4129700,-42882,0,-18998,23884
-10,2341,20160527,2365,515564,2286,2351,708954,2306,2320,522746,9815212.8,4230252,-18998,1,-7182,11816
106,2436,20160530,2436,599444,2323,2330,817000,2320,2382,566842,11536760.96,4843350,-7182,0,32602,39784
-14,2426,20160531,2460,599672,2412,2440,795744,2382,2436,569788,8202309.85,3367126,32602,0,29884,-2718
-24,2399,20160601,2453,626566,2371,2423,870862,2436,2412,613638,10788077.79,4473308,29884,0,12928,-16956
100,2498,20160602,2520,727354,2386,2398,1016562,2412,2462,686636,11405805.54,4632422,12928,0,40718,27790
46,2553,20160603,2557,738652,2481,2507,1054782,2462,2520,703616,10524108.02,4176714,40718,-1,35036,-5682
-3,2567,20160606,2578,721174,2526,2570,1010620,2520,2552,666404,9320938.41,3651898,35036,1,54770,19734
13,2581,20160607,2603,727474,2541,2568,1004428,2552,2571,659114,10866166.52,4226136,54770,0,68360,13590
17,2590,20160608,2590,693318,2538,2573,928260,2571,2565,631060,8686109.86,3385966,68360,-1,62258,-6102
25,2694,20160613,2694,719124,2640,2669,905916,2565,2665,589584,2579287.83,968006,62258,0,129540,67282
-66,2655,20160614,2781,620748,2626,2721,754576,2665,2704,532970,13167834.31,4870246,129540,0,87778,-41762
43,2712,20160615,2731,806692,2643,2669,1008740,2704,2689,657170,15877741.76,5904132,87778,0,149522,61744
-110,2620,20160616,2740,699538,2606,2730,906788,2689,2667,615398,15141233.88,5676760,149522,0,84140,-65382
36,2657,20160617,2660,746262,2584,2621,950072,2667,2620,661004,11447255.05,4368494,84140,0,85258,1118
22,2684,20160620,2696,787172,2642,2662,1001538,2620,2667,685394,9860061.11,3696476,85258,0,101778,16520
-16,2661,20160621,2712,744736,2652,2677,976328,2667,2677,672754,10829489.52,4044748,101778,0,71982,-29796
46,2675,20160622,2675,746424,2603,2629,967176,2677,2638,681030,9089386.77,3445900,71982,-1,65394,-6588
-20,2635,20160623,2692,757768,2613,2655,957184,2638,2658,689696,11078584.38,4167636,65394,1,68072,2678
-2,2632,20160624,2694,742198,2620,2634,937838,2658,2657,670982,16188873.67,6092828,68072,1,71216,3144
119,2738,20160627,2742,811280,2612,2619,1020548,2657,2680,690784,10839154.3,4043722,71216,0,120496,49280
84,2814,20160628,2814,812608,2718,2730,1031874,2680,2766,711930,10419448.19,3766696,120496,-1,100678,-19818
-32,2818,20160629,2877,715732,2775,2850,861656,2766,2826,640740,13397847.83,4740962,100678,0,74992,-25686
75,2889,20160630,2895,828044,2803,2814,1030086,2826,2856,718378,12528757.93,4387536,74992,0,109666,34674
26,2908,20160701,2972,792938,2840,2882,958392,2856,2894,723084,12508953.16,4322182,109666,-1,69854,-39812
30,2930,20160704,3003,713074,2894,2900,830648,2894,2946,633096,11945124.05,4055120,69854,0,79978,10124
-118,2814,20160705,2944,640590,2798,2932,733880,2946,2852,624936,11820424.93,4144514,79978,0,15654,-64324
-81,2724,20160706,2853,607962,2710,2805,673726,2852,2769,567156,13703306.25,4949224,15654,1,40806,25152
-60,2630,20160707,2755,581370,2630,2690,680322,2769,2687,575624,10018440.46,3729152,40806,0,5746,-35060
-111,2528,20160708,2646,483878,2507,2639,568960,2687,2574,485340,9950071.55,3866298,5746,0,-1462,-7208
-6,2540,20160711,2596,543916,2501,2546,689408,2574,2545,574424,10831637.64,4255516,-1462,0,-30508,-29046
35,2579,20160712,2591,527896,2512,2544,601080,2545,2560,519740,11690685.69,4565966,-30508,0,8156,38664
112,2688,20160713,2688,538498,2563,2576,572402,2560,2652,504346,13427927.32,5063136,8156,0,34152,25996
-8,2702,20160714,2754,514376,2675,2710,514348,2652,2714,485988,9214477.72,3395364,34152,0,28388,-5764
-128,2578,20160715,2711,494442,2578,2706,549744,2714,2634,495566,6678707.78,2535116,28388,0,-1124,-29512
-22,2538,20160718,2598,465276,2522,2560,488602,2634,2562,455320,5463005.02,2132296,-1124,1,9956,11080
56,2589,20160719,2606,491764,2524,2533,534216,2562,2567,503702,7489792.86,2917416,9956,-1,-11938,-21894
-60,2517,20160720,2584,523984,2460,2577,568412,2567,2525,515676,9061210.04,3588336,-11938,1,8308,20246
44,2554,20160721,2569,538970,2470,2510,576244,2525,2511,522678,7374143.71,2936482,8308,0,16292,7984
-105,2450,20160722,2584,511256,2439,2555,566106,2511,2512,539796,8201235.22,3264174,16292,0,-28540,-44832
20,2458,20160725,2476,480848,2416,2438,541862,2512,2450,515706,5675812.85,2316252,-28540,-1,-34858,-6318
21,2485,20160726,2492,493410,2435,2464,540456,2450,2462,516984,5405257.74,2195534,-34858,0,-23574,11284
19,2492,20160727,2537,488244,2468,2473,530608,2462,2504,519532,5805541.4,2318196,-23574,-1,-31288,-7714
-20,2492,20160728,2544,474300,2474,2512,512310,2504,2512,514612,5514250.93,2195550,-31288,0,-40312,-9024
-11,2474,20160729,2539,489448,2463,2485,518432,2512,2503,539258,5338841.01,2133200,-40312,0,-49810,-9498
26,2509,20160801,2531,501514,2479,2483,516974,2503,2507,537694,3660784.65,1459944,-49810,0,-36180,13630
-34,2466,20160802,2511,460022,2424,2500,453848,2507,2469,496070,3899778.65,1579688,-36180,1,-36048,132
9,2469,20160803,2492,451900,2447,2460,419044,2469,2469,496946,2858921.21,1158120,-36048,-1,-45046,-8998
36,2311,20160804,2316,478494,2252,2275,421514,2258,2281,519014,2461693.08,1079178,-45046,0,-40520,4526
54,2370,20160805,2375,507954,2307,2316,503702,2281,2342,519246,3454991.11,1475170,-40520,0,-11292,29228
-10,2357,20160808,2406,482036,2354,2367,522486,2342,2374,521262,3444086.7,1450448,-11292,0,-39226,-27934
23,2384,20160809,2403,478634,2346,2361,551164,2374,2378,500500,3666508.08,1541746,-39226,0,-21866,17360
67,2442,20160810,2446,546310,2365,2375,637020,2378,2420,534630,4439698.58,1834610,-21866,0,11680,33546
-28,2408,20160811,2447,520690,2403,2436,637674,2420,2426,538110,3556065.84,1465870,11680,0,-17420,-29100
-17,2390,20160812,2427,530232,2378,2407,672466,2426,2402,536672,3608201.41,1502164,-17420,1,-6440,10980
50,2431,20160815,2443,525408,2338,2381,680374,2402,2393,528786,4466273.74,1866548,-6440,0,-3378,3062
-8,2419,20160816,2463,512746,2410,2427,693468,2393,2440,539656,4614102.18,1891252,-3378,0,-26910,-23532
-10,2412,20160817,2433,504292,2399,2422,719260,2440,2416,545612,3494609.42,1446296,-26910,0,-41320,-14410
-58,2359,20160818,2444,469706,2351,2417,740854,2416,2408,565706,5008974.54,2080200,-41320,0,-96000,-54680
-51,2309,20160819,2368,462140,2288,2360,717662,2408,2328,552142,5022465.99,2157718,-96000,1,-90002,5998
17,2325,20160822,2336,455952,2297,2308,696740,2328,2318,510402,2966447.28,1279528,-90002,0,-54450,35552
-9,2312,20160823,2354,469972,2306,2321,710486,2318,2329,514378,3011994.88,1293212,-54450,1,-44406,10044
-40,2278,20160824,2326,475772,2273,2318,745936,2329,2298,530484,3679458.05,1600962,-44406,0,-54712,-10306
40,2319,20160825,2324,515142,2261,2279,750214,2298,2290,525836,4135097.94,1805816,-54712,0,-10694,44018
-28,2294,20160826,2328,481620,2281,2322,712626,2290,2301,519118,4395697.18,1910288,-10694,0,-37498,-26804
-25,2280,20160829,2318,492856,2268,2305,749226,2301,2296,548400,3568100.86,1554290,-37498,0,-55544,-18046
-8,2268,20160830,2290,499518,2258,2276,749564,2296,2275,544636,2642740.81,1161526,-55544,1,-45118,10426
-34,2236,20160831,2277,503468,2226,2270,790192,2275,2250,578608,2719620.54,1208624,-45118,0,-75140,-30022
-13,2214,20160901,2233,540454,2181,2227,834518,2250,2211,612414,3630619.16,1642392,-75140,1,-71960,3180
-1,2213,20160902,2244,517412,2202,2214,793708,2211,2220,586142,3067077.54,1381412,-71960,1,-68730,3230
-35,2185,20160905,2233,537710,2172,2220,838050,2220,2208,618322,2985511.18,1352306,-68730,0,-80612,-11882
33,2223,20160906,2227,523160,2181,2190,797022,2208,2207,570728,2540083.44,1150760,-80612,0,-47568,33044
46,2266,20160907,2275,515942,2213,2220,758042,2207,2243,543556,3563235.04,1588302,-47568,0,-27614,19954
5,2273,20160908,2282,513846,2253,2268,748902,2243,2268,524780,2661319.08,1173352,-27614,0,-10934,16680
-12,2262,20160909,2282,508984,2250,2274,726126,2268,2263,512714,2091540.01,924080,-10934,1,-3730,7204
10,2270,20160912,2311,483450,2240,2260,694898,2263,2270,481930,3046651.53,1341938,-3730,0,1520,5250
-19,2258,20160913,2294,469262,2243,2277,662424,2270,2270,472130,2829761.25,1246682,1520,0,-2868,-4388
-28,2221,20160914,2254,453514,2203,2249,630556,2270,2222,451302,2297306.55,1033886,-2868,1,2212,5080
31,2290,20160919,2295,461832,2253,2259,624104,2222,2277,444058,1461577.59,641914,2212,0,17774,15562
16,2305,20160920,2309,484166,2276,2289,674098,2277,2293,482306,2579855,1125170,17774,-1,1860,-15914
-3,2308,20160921,2335,494734,2300,2311,672420,2293,2316,488552,2608637.64,1126184,1860,1,6182,4322
-34,2276,20160922,2329,478086,2269,2310,664800,2316,2299,512622,3400928.69,1479178,6182,0,-34536,-40718
-47,2241,20160923,2294,463778,2235,2288,679216,2299,2264,527530,2722121.33,1202412,-34536,0,-63752,-29216
-19,2223,20160926,2253,441168,2217,2242,669680,2264,2240,526918,2105288.81,939856,-63752,0,-85750,-21998
-19,2200,20160927,2229,431534,2190,2219,659486,2240,2213,514202,2183259.04,986652,-85750,1,-82668,3082
-1,2203,20160928,2210,421932,2182,2204,639132,2213,2199,505526,1646816.36,749026,-82668,0,-83594,-926
13,2214,20160929,2235,380238,2197,2201,565278,2199,2219,466170,1745472.65,786738,-83594,-1,-85932,-2338
-43,2171,20160930,2226,340824,2152,2214,498562,2219,2179,410028,2154634.43,988838,-85932,1,-69204,16728
-20,2148,20161010,2180,358536,2120,2168,543514,2179,2143,441090,1066038.13,497364,-69204,0,-82554,-13350
23,2170,20161011,2176,372988,2145,2147,569784,2143,2162,445950,1785941.79,826084,-82554,0,-72962,9592
-27,2144,20161012,2196,373380,2131,2171,597518,2162,2168,477404,2548558.07,1175786,-72962,0,-104024,-31062
-15,2135,20161013,2174,396480,2124,2150,622080,2168,2149,501152,2293554.86,1067380,-104024,0,-104672,-648
30,2174,20161014,2185,353976,2121,2144,571582,2149,2158,449876,2545712.25,1179544,-104672,0,-95900,8772
41,2219,20161017,2221,366072,2175,2178,585452,2158,2199,460316,3088520.48,1404292,-95900,0,-94244,1656
5,2228,20161018,2233,350282,2196,2223,570942,2199,2218,447516,2290509.43,1032548,-94244,-1,-97234,-2990
-24,2195,20161019,2239,340302,2181,2219,574088,2218,2212,451326,2418022.44,1093024,-97234,0,-111024,-13790
61,2253,20161020,2257,356576,2187,2192,592498,2212,2227,450868,2589599.41,1162624,-111024,0,-94292,16732
10,2266,20161021,2269,363962,2228,2256,592406,2227,2250,449976,2751881.11,1222936,-94292,0,-86014,8278
16,2286,20161024,2287,365030,2244,2270,592194,2250,2266,443652,2288529.13,1009808,-86014,0,-78622,7392
-30,2259,20161025,2297,359416,2251,2289,565114,2266,2273,448370,2547645.93,1120800,-78622,0,-88954,-10332
30,2291,20161026,2298,363606,2234,2261,542398,2273,2271,431436,3290197.34,1448778,-88954,0,-67830,21124
60,2351,20161027,2358,416182,2280,2291,586466,2271,2320,492702,3909676.35,1685326,-67830,-1,-76520,-8690
2,2340,20161028,2361,389488,2330,2338,546954,2320,2343,470564,2400278.54,1024464,-76520,-1,-81076,-4556
-31,2305,20161031,2353,405730,2303,2336,563904,2343,2323,512206,2125922.36,915200,-81076,0,-106476,-25400
-1,2298,20161101,2330,426294,2288,2299,578838,2323,2312,543320,2392579.49,1034632,-106476,0,-117026,-10550
-106,2196,20161102,2319,402586,2196,2302,589794,2312,2252,553338,3241858.99,1439360,-117026,0,-150752,-33726
-11,2192,20161103,2212,401614,2179,2203,592270,2252,2196,545410,2297198.01,1046170,-150752,1,-143796,6956
-33,2166,20161104,2215,396592,2153,2199,584850,2196,2183,564206,2518221.41,1153650,-143796,0,-167614,-23818
39,2210,20161107,2219,380368,2166,2171,543514,2183,2192,538702,2104974.99,960156,-167614,0,-158334,9280
27,2233,20161108,2247,380076,2201,2206,522094,2192,2221,535704,2469554.26,1111942,-158334,0,-155628,2706
-35,2198,20161109,2245,385356,2175,2233,537176,2221,2214,556564,2690913.43,1215468,-155628,0,-171208,-15580
113,2325,20161110,2325,436164,2211,2212,517140,2214,2267,564032,4624707.54,2040344,-171208,0,-127868,43340
76,2405,20161111,2426,483090,2327,2329,516354,2267,2383,595536,4811287.03,2019370,-127868,0,-112446,15422
-137,2263,20161114,2447,387254,2263,2400,440262,2383,2316,535682,3456594.46,1492738,-112446,0,-148428,-35982
1,2247,20161115,2294,343224,2209,2246,371420,2316,2251,487674,1917967.58,852174,-148428,0,-144450,3978
64,2315,20161116,2319,384326,2251,2251,430510,2251,2289,531382,2481229.08,1084060,-144450,-1,-147056,-2606
8,2318,20161117,2336,397786,2290,2310,441456,2289,2314,547570,2335553.57,1009110,-147056,-1,-149784,-2728
-25,2295,20161118,2330,381470,2273,2320,419730,2314,2294,522776,1958112,853508,-149784,1,-141306,8478
88,2383,20161121,2403,464896,2295,2295,494658,2294,2351,612386,2884591.22,1226780,-141306,-1,-147490,-6184
31,2414,20161122,2445,454826,2363,2383,449890,2351,2409,592946,2576578.77,1069704,-147490,0,-138120,9370
6,2412,20161123,2462,473464,2370,2406,438834,2409,2425,604406,2002159.52,825710,-138120,0,-130942,7178
-33,2377,20161124,2444,421336,2362,2410,378214,2425,2408,571592,2028293.17,842414,-130942,0,-150256,-19314
-14,2440,20161125,2475,431338,2411,2454,388358,2463,2442,578926,1044192.83,427564,-150256,1,-147588,2668
97,2534,20161128,2551,518954,2436,2437,532978,2442,2503,638888,1990284.4,795102,-147588,0,-119934,27654
-20,2508,20161129,2553,509978,2482,2528,571174,2503,2522,644628,2067178.06,819504,-119934,0,-134650,-14716
-40,2450,20161130,2503,459618,2413,2490,513338,2522,2459,582592,2457072.94,999372,-134650,1,-122974,11676
-4,2456,20161201,2510,469644,2425,2460,546998,2459,2467,605714,2661162.26,1078832,-122974,0,-136070,-13096
-38,2422,20161202,2471,466986,2395,2460,565972,2467,2427,609692,2266656.87,933996,-136070,0,-142706,-6636
25,2447,20161205,2455,489750,2409,2422,616304,2427,2436,621034,1897767.8,779096,-142706,0,-131284,11422
-9,2446,20161206,2483,472768,2420,2455,606450,2436,2460,619156,2134781.33,867904,-131284,0,-146388,-15104
11,2468,20161207,2485,478864,2447,2457,635900,2460,2467,630286,2138608.61,866980,-146388,-1,-151422,-5034
-37,2429,20161208,2478,450562,2417,2466,613744,2467,2444,610688,2005015.82,820228,-151422,0,-160126,-8704
-47,2388,20161209,2436,444764,2358,2435,600414,2444,2390,599056,2088062.57,873588,-160126,1,-154292,5834
47,2443,20161212,2465,435212,2386,2396,590814,2390,2430,588174,1915848.2,788574,-154292,0,-152962,1330
35,2470,20161213,2473,466602,2431,2435,648938,2430,2453,628532,1940018.76,790906,-152962,-1,-161930,-8968
-56,2418,20161214,2480,435190,2411,2474,613668,2453,2443,602444,2142206.65,876914,-161930,0,-167254,-5324
10,2426,20161215,2435,435228,2391,2416,623042,2443,2416,607468,1480894.32,612922,-167254,-1,-172240,-4986
13,2431,20161216,2458,432070,2406,2418,629688,2416,2435,599562,1730391.11,710566,-172240,0,-167492,4748
-1,2429,20161219,2463,435026,2412,2430,631930,2435,2442,606122,2204066.19,902696,-167492,0,-171096,-3604
-80,2343,20161220,2433,397056,2335,2423,591352,2442,2381,594802,2417458.55,1015272,-171096,0,-197746,-26650
-21,2327,20161221,2357,391636,2320,2348,611328,2381,2339,601592,1843936.26,788458,-197746,0,-209956,-12210
-24,2306,20161222,2354,399080,2300,2330,620368,2339,2329,597898,1524115.06,654310,-209956,1,-198818,11138
16,2318,20161223,2328,394392,2288,2302,615856,2329,2311,583576,1645876.88,712160,-198818,0,-189184,9634
-43,2281,20161226,2335,403930,2265,2324,625090,2311,2297,588548,1613324.75,702348,-189184,1,-184618,4566
40,2320,20161227,2325,372066,2279,2280,585036,2297,2304,546462,1230179.62,533988,-184618,0,-174396,10222
13,2342,20161228,2363,349122,2325,2329,549396,2304,2341,512524,1387337.61,592668,-174396,0,-163402,10994
-13,2336,20161229,2350,338922,2307,2349,527582,2341,2332,491298,1168778.49,501190,-163402,1,-152376,11026
-36,2308,20161230,2356,330350,2302,2344,513852,2332,2324,485142,1290128.25,555082,-152376,0,-154792,-2416
-22,2278,20170103,2324,358782,2271,2300,558252,2324,2291,528304,844762.19,368658,-154792,0,-169522,-14730
31,2310,20170104,2314,366880,2261,2279,571046,2291,2291,535376,1437354.85,627512,-169522,0,-168496,1026
-11,2301,20170105,2336,371196,2297,2312,564484,2291,2313,539140,1221800.27,528206,-168496,1,-167944,552
-2,2296,20170106,2313,375166,2282,2298,566928,2313,2296,548452,1030273.36,448700,-167944,0,-173286,-5342
-6,2290,20170109,2316,414494,2269,2296,617382,2296,2293,601498,1587613.66,692348,-173286,0,-187004,-13718
-1,2291,20170110,2313,438184,2272,2292,661598,2293,2291,645054,1673327.33,730262,-187004,0,-206870,-19866
41,2331,20170111,2347,434786,2286,2290,645714,2291,2321,602172,2236598.81,963544,-206870,0,-167386,39484
-5,2324,20170112,2345,417526,2312,2329,607116,2321,2330,592454,1398941.2,600514,-167386,0,-174928,-7542
59,2386,20170113,2412,440060,2324,2327,642622,2330,2373,609124,2139325.06,901686,-174928,0,-169064,5864
38,2426,20170116,2433,451912,2377,2388,663630,2373,2408,617810,1617778.74,671720,-169064,0,-165898,3166
10,2435,20170117,2462,455764,2416,2425,644878,2408,2437,619426,1671136.63,685680,-165898,0,-163662,2236
-2,2446,20170118,2462,475434,2419,2448,624882,2437,2439,638092,1533365.09,628656,-163662,1,-162658,1004
23,2464,20170119,2473,523204,2431,2441,664100,2439,2453,668254,1486350.87,605942,-162658,0,-145050,17608
-29,2432,20170120,2468,516008,2422,2461,606536,2453,2440,661648,1306688.59,535538,-145050,0,-145640,-590
0,2432,20170123,2439,558434,2407,2432,629792,2440,2426,701070,1108058.07,456828,-145640,0,-142636,3004
13,2443,20170124,2457,567644,2419,2430,631250,2426,2439,719162,1103254.06,452302,-142636,-1,-151518,-8882
-54,2391,20170125,2445,553618,2385,2445,595760,2439,2407,714680,1327327.92,551462,-151518,0,-161062,-9544
18,2414,20170126,2426,475396,2396,2396,530166,2407,2411,631600,732983.99,304004,-161062,0,-156204,4858
5,2405,20170203,2431,477938,2363,2400,552454,2411,2402,633910,657161.17,273584,-156204,0,-155972,232
48,2452,20170206,2469,586746,2403,2404,753160,2402,2439,734676,2292748.78,939964,-155972,0,-147930,8042
-5,2450,20170207,2480,614450,2444,2455,776398,2439,2456,761004,1316645.07,536126,-147930,1,-146554,1376
45,2493,20170208,2494,659778,2420,2448,824552,2456,2468,788896,1825246.5,739534,-146554,0,-129118,17436
-14,2480,20170209,2508,629866,2474,2494,770320,2468,2490,765132,1330605.42,534478,-129118,0,-135266,-6148
38,2518,20170210,2522,670924,2476,2480,834790,2490,2498,811270,1742908.87,697612,-135266,-1,-140346,-5080
-12,2506,20170213,2538,663174,2496,2518,793262,2498,2516,798398,1558097.82,619212,-140346,1,-135224,5122
-31,2480,20170214,2526,663274,2480,2511,794246,2516,2502,804146,1517046.71,606304,-135224,0,-140872,-5648
-23,2465,20170215,2491,680836,2461,2488,782030,2502,2477,821972,1344621.36,542894,-140872,0,-141136,-264
20,2478,20170216,2512,673176,2450,2458,779974,2477,2488,823496,1712524.75,688224,-141136,-1,-150320,-9184
-48,2430,20170217,2505,651156,2421,2478,724566,2488,2465,812486,2153954.1,873734,-150320,0,-161330,-11010
4,2438,20170220,2447,619890,2423,2434,691052,2465,2436,800562,931529.32,382390,-161330,-1,-180672,-19342
25,2467,20170221,2488,608656,2432,2442,661664,2436,2461,796242,1575679.49,640358,-180672,-1,-187586,-6914
-38,2429,20170222,2477,618680,2412,2467,658224,2461,2444,803274,1402175.17,573610,-187586,1,-184594,2992
-46,2384,20170223,2444,585766,2384,2430,619144,2444,2417,786818,1335588.52,552650,-184594,0,-201052,-16458
9,2394,20170224,2397,592894,2360,2385,610826,2417,2382,780976,1120427.2,470470,-201052,0,-188082,12970
15,2411,20170227,2416,593618,2384,2396,602928,2382,2404,781020,1030699.06,428776,-188082,0,-187402,680
-19,2396,20170228,2420,601654,2391,2415,606580,2404,2403,793724,928170.53,386186,-187402,0,-192070,-4668
30,2426,20170301,2446,608190,2393,2396,598994,2403,2425,792832,1417784.75,584536,-192070,0,-184642,7428
25,2459,20170302,2465,619526,2425,2434,587098,2425,2448,796130,1105921.35,451766,-184642,0,-176604,8038
-3,2450,20170303,2457,622604,2427,2453,581046,2448,2442,809722,894465.32,366322,-176604,0,-187118,-10514
37,2488,20170306,2491,680310,2440,2451,644552,2442,2468,853658,1376690.07,557836,-187118,0,-173348,13770
-4,2480,20170307,2493,661092,2471,2484,620928,2468,2482,849332,1018825.81,410510,-173348,0,-188240,-14892
-54,2423,20170308,2479,617860,2420,2477,576620,2482,2447,831206,1326272.52,541972,-188240,0,-213346,-25106
6,2421,20170309,2435,608008,2406,2415,537324,2447,2422,813554,930666.18,384184,-213346,0,-205546,7800
-29,2384,20170310,2422,611742,2380,2413,534830,2422,2399,819478,1102979.64,459766,-205546,0,-207736,-2190
10,2395,20170313,2408,592160,2375,2385,494770,2399,2392,795282,927284.48,387710,-207736,0,-203122,4614
-37,2358,20170314,2416,626820,2342,2395,552924,2392,2376,822958,1519782.54,639526,-203122,1,-196138,6984
36,2388,20170315,2398,578088,2335,2352,447406,2376,2371,749736,1210477.88,510598,-196138,0,-171648,24490
-11,2381,20170316,2401,593140,2361,2392,469088,2371,2382,778564,805886.93,338342,-171648,0,-185424,-13776
-13,2393,20170317,2409,587302,2369,2406,483768,2400,2386,784918,570141.26,238928,-185424,0,-197616,-12192
48,2434,20170320,2438,606042,2380,2386,539272,2386,2416,796896,856781.16,354602,-197616,0,-190854,6762
-17,2412,20170321,2445,616816,2398,2429,591044,2416,2422,813050,1151491.33,475334,-190854,0,-196234,-5380
-4,2407,20170322,2418,635576,2388,2411,647822,2422,2405,843588,1508610.41,627296,-196234,0,-208012,-11778
-50,2354,20170323,2414,652238,2354,2404,710214,2405,2383,860104,2138914.87,897572,-208012,1,-207866,146
-13,2338,20170324,2374,610130,2331,2351,665596,2383,2348,806984,1489690.13,634322,-207866,1,-196854,11012
1,2341,20170327,2348,634734,2309,2340,710102,2348,2333,823010,1477772.18,633482,-196854,0,-188276,8578
-1,2338,20170328,2353,604320,2330,2339,704086,2333,2343,805032,1348440.62,575496,-188276,0,-200712,-12436
15,2360,20170329,2365,623478,2325,2345,748286,2343,2345,820548,1729631.13,737514,-200712,0,-197070,3642
-20,2339,20170330,2362,600422,2327,2359,740078,2345,2343,805968,1389397.47,593020,-197070,0,-205546,-8476
-5,2334,20170331,2354,602608,2302,2339,749918,2343,2332,805792,2033571.62,872198,-205546,1,-203184,2362
10,2316,20170405,2328,614428,2299,2306,792230,2332,2316,826200,1062581.54,458744,-203184,-1,-211772,-8588
3,2319,20170406,2332,643310,2305,2316,874868,2316,2318,862046,1433775.02,618666,-211772,-1,-218736,-6964
-32,2289,20170407,2323,620132,2283,2321,864950,2318,2300,845604,1596286.96,694136,-218736,0,-225472,-6736
33,2326,20170410,2340,616818,2292,2293,853534,2300,2316,821122,1719518.98,742592,-225472,0,-204304,21168
1,2332,20170411,2338,621078,2309,2331,847834,2316,2326,812748,1239440.73,532954,-204304,0,-191670,12634
37,2365,20170412,2379,671560,2306,2328,908484,2326,2352,839946,2401168.8,1020838,-191670,0,-168386,23284
38,2408,20170413,2408,640800,2360,2370,882566,2352,2385,811342,1836402.44,770008,-168386,-1,-170542,-2156
0,2410,20170414,2424,639006,2395,2410,872004,2385,2409,809224,1915417.23,795208,-170542,0,-170218,324
13,2419,20170417,2429,635664,2391,2406,884808,2409,2409,803132,1916635.53,795622,-170218,0,-167468,2750
-10,2405,20170418,2428,641760,2400,2415,908902,2409,2415,806668,1949995.11,807542,-167468,1,-164908,2560
44,2449,20170419,2450,706910,2384,2405,998990,2415,2429,863590,2387910.47,983178,-164908,0,-156680,8228
-2,2441,20170420,2455,721306,2415,2443,1036024,2429,2433,900606,2092482.12,859876,-156680,0,-179300,-22620
-6,2436,20170421,2445,699746,2418,2442,1030796,2433,2431,893470,1683143.66,692256,-179300,0,-193724,-14424
29,2464,20170424,2479,773592,2421,2435,1119082,2431,2457,924664,2475571.61,1007502,-193724,0,-151072,42652
-8,2460,20170425,2474,721294,2451,2468,1061080,2457,2462,892714,1301054.87,528442,-151072,0,-171420,-20348
-56,2403,20170426,2470,719136,2403,2459,1068532,2462,2432,883244,2794770.48,1149058,-171420,1,-164108,7312
-17,2392,20170427,2419,685090,2388,2409,1030846,2432,2403,870800,1900159.44,790776,-164108,0,-185710,-21602
3,2399,20170428,2414,677188,2393,2396,1005384,2403,2403,865560,1463910.93,609096,-185710,-1,-188372,-2662
53,2477,20170502,2486,753492,2424,2424,1076436,2403,2462,897250,2048189.71,832042,-188372,0,-143758,44614
-4,2467,20170503,2478,728634,2457,2471,1059782,2462,2468,891736,1497167.08,606532,-143758,0,-163102,-19344
5,2473,20170504,2483,766062,2445,2468,1096866,2468,2468,909704,2879966.59,1166942,-163102,0,-143642,19460
-18,2449,20170505,2494,754736,2446,2467,1102338,2468,2470,906066,3160359.5,1279706,-143642,0,-151330,-7688
-42,2420,20170508,2473,727264,2412,2462,1048500,2470,2442,886036,2940853.9,1204404,-151330,0,-158772,-7442
-6,2414,20170509,2425,697894,2400,2420,1003548,2442,2413,835734,1553750.26,643954,-158772,1,-137840,20932
14,2430,20170510,2438,704214,2413,2416,1001326,2413,2428,851950,1491511.77,614200,-137840,-1,-147736,-9896
2,2431,20170511,2441,704224,2402,2429,1020934,2428,2421,840736,2105553.92,869842,-147736,0,-136512,11224
-56,2372,20170512,2433,695600,2368,2428,1026590,2421,2401,848912,2445658.73,1018510,-136512,0,-153312,-16800
-13,2358,20170515,2384,677368,2357,2371,1006258,2401,2369,837930,1664732.29,702662,-153312,0,-160562,-7250
-19,2346,20170516,2373,695378,2336,2365,1036198,2369,2353,876866,1551801.5,659628,-160562,0,-181488,-20926
22,2373,20170517,2379,657872,2349,2351,980466,2353,2365,835298,1447239.45,611966,-181488,0,-177426,4062
-46,2327,20170518,2376,698824,2317,2373,1041764,2365,2339,887564,1626389.64,695354,-177426,0,-188740,-11314
13,2323,20170519,2336,669802,2296,2310,1024004,2339,2322,870168,1661934.14,715870,-188740,-1,-200366,-11626
15,2345,20170522,2356,708352,2311,2330,1054642,2322,2338,910756,1988724.1,850594,-200366,-1,-202404,-2038
-20,2322,20170523,2351,700634,2319,2342,1040684,2338,2336,906528,1342776.96,574934,-202404,0,-205894,-3490
4,2330,20170524,2343,741764,2307,2326,1103122,2336,2326,965784,1893825.76,814248,-205894,-1,-224020,-18126
-8,2330,20170525,2346,714036,2322,2338,1057184,2326,2334,919852,1361685.92,583418,-224020,1,-205816,18204
-41,2293,20170526,2334,745178,2289,2334,1094686,2334,2307,953784,1502370.6,651298,-205816,0,-208606,-2790
-79,2187,20170531,2271,710502,2176,2266,1033388,2307,2218,901628,2034248.82,916950,-208606,1,-191126,17480
12,2205,20170601,2217,703978,2191,2193,1007052,2218,2206,898222,1245018.01,564464,-191126,-1,-194244,-3118
-8,2207,20170602,2228,720660,2192,2215,1022662,2206,2210,913932,1117374.07,505586,-194244,1,-193272,972
4,2219,20170605,2249,705318,2212,2215,984802,2210,2230,891938,1460036.5,654848,-193272,0,-186620,6652
-3,2218,20170606,2229,705482,2208,2221,974316,2230,2219,879888,1094121.43,493134,-186620,1,-174406,12214
5,2223,20170607,2245,697210,2215,2218,963044,2219,2229,879142,1174247.15,526836,-174406,-1,-181932,-7526
-4,2232,20170608,2240,689722,2221,2236,950422,2229,2231,875066,1103031.89,494404,-181932,0,-185344,-3412
1,2237,20170609,2258,685456,2232,2236,922636,2231,2243,871930,1377187.75,614120,-185344,-1,-186474,-1130
-8,2235,20170612,2255,683570,2221,2243,933488,2243,2236,877768,1381176.36,617606,-186474,0,-194198,-7724
-4,2221,20170613,2229,671962,2211,2225,925386,2236,2221,862790,1052635.13,473910,-194198,1,-190828,3370
19,2243,20170614,2252,654772,2222,2224,890578,2221,2241,845140,1312328.54,585590,-190828,0,-190368,460
-6,2238,20170615,2268,648740,2227,2244,872464,2241,2240,833188,1075805.01,480172,-190368,1,-184448,5920
25,2253,20170616,2267,658152,2220,2228,865062,2240,2248,837468,1266197.05,563270,-184448,0,-179316,5132
15,2272,20170619,2286,636256,2246,2257,822194,2248,2266,802384,1250615.67,552000,-179316,0,-166128,13188
10,2275,20170620,2277,619858,2259,2265,797514,2266,2269,792698,721694.67,318052,-166128,-1,-172840,-6712
8,2273,20170621,2279,622228,2255,2265,801166,2269,2268,782814,1033537.45,455792,-172840,0,-160586,12254
-43,2232,20170622,2282,617344,2228,2275,836558,2268,2249,805336,1286425.57,572090,-160586,0,-187992,-27406
1,2219,20170623,2235,620788,2210,2218,842384,2249,2221,802732,977350.78,440118,-187992,0,-181944,6048
5,2228,20170626,2236,611896,2214,2223,807478,2221,2227,793650,718093.21,322450,-181944,0,-181754,190
-3,2230,20170627,2234,629082,2217,2233,833270,2227,2226,817372,741472.86,333060,-181754,0,-188290,-6536
-13,2224,20170628,2245,636340,2214,2237,843976,2226,2231,837094,924024.76,414186,-188290,0,-200754,-12464
7,2234,20170629,2240,622146,2222,2227,828644,2231,2231,827516,928532.9,416108,-200754,-1,-205370,-4616
-24,2216,20170630,2262,657140,2202,2240,888284,2231,2234,877292,1794314.3,803184,-205370,0,-220152,-14782
110,2328,20170703,2337,620700,2218,2218,775484,2234,2301,807832,2415689.17,1049980,-220152,0,-187132,33020
9,2341,20170704,2343,594278,2319,2332,703018,2301,2332,752996,1688408.85,723954,-187132,0,-158718,28414
3,2344,20170705,2348,604456,2326,2341,687816,2332,2337,740644,1107514.4,473992,-158718,0,-136188,22530
-1,2343,20170706,2363,582614,2333,2344,679578,2337,2346,740170,1510818.83,643976,-136188,0,-157556,-21368
8,2349,20170707,2362,563546,2334,2341,650380,2346,2349,709822,1059198.63,450938,-157556,0,-146276,11280
51,2406,20170710,2425,624904,2325,2355,702958,2349,2380,750248,2258951.99,949176,-146276,0,-125344,20932
8,2411,20170711,2427,585326,2389,2403,625858,2380,2410,702760,1394647.75,578632,-125344,0,-117434,7910
16,2416,20170712,2426,586782,2397,2400,616164,2410,2415,683944,925393.57,383156,-117434,0,-97162,20272
-22,2393,20170713,2449,630298,2381,2415,672236,2415,2409,724000,2120049.07,879872,-97162,1,-93702,3460
-43,2340,20170714,2395,571050,2330,2383,623264,2409,2355,695804,1749373.84,742938,-93702,0,-124754,-31052
-11,2335,20170717,2361,566932,2331,2346,631286,2355,2345,706718,1236734.13,527334,-124754,0,-139786,-15032
-11,2339,20170718,2356,569496,2318,2350,612200,2345,2342,703234,1147140.09,489812,-139786,1,-133738,6048
-17,2334,20170719,2356,580832,2323,2351,609704,2342,2341,722242,1139517.42,486764,-133738,0,-141410,-7672
5,2345,20170720,2352,565574,2328,2340,582894,2341,2341,699132,1201264.53,513046,-141410,0,-133558,7852
3,2358,20170721,2366,567920,2340,2355,563786,2341,2354,690222,1262060.99,536132,-133558,0,-122302,11256
-61,2289,20170724,2357,529498,2281,2350,506948,2354,2312,640328,1420629.99,614484,-122302,1,-110830,11472
42,2330,20170725,2339,526804,2284,2288,474912,2312,2315,628864,1154421.62,498628,-110830,0,-102060,8770
-48,2276,20170726,2329,510580,2267,2324,464478,2315,2292,627348,1093276.42,476992,-102060,0,-116768,-14708
18,2285,20170727,2300,510946,2251,2267,450322,2292,2278,619550,841694.46,369486,-116768,0,-108604,8164
-3,2291,20170728,2313,488176,2280,2294,404564,2278,2295,578812,1049546.35,457388,-108604,1,-90636,17968
40,2333,20170731,2335,486980,2282,2293,389996,2295,2307,581066,1058599.81,458790,-90636,-1,-94086,-3450
-4,2243,20170801,2267,478526,2243,2247,395234,2239,2252,565172,372591.32,165444,-94086,1,-86646,7440
-25,2215,20170802,2245,478144,2206,2240,424108,2252,2221,579658,516431.04,232564,-86646,0,-101514,-14868
-50,2165,20170803,2224,484700,2163,2215,478480,2221,2198,597866,620031.04,282104,-101514,0,-113166,-11652
16,2182,20170804,2188,510802,2160,2166,533468,2198,2175,620370,668893.52,307550,-113166,0,-109568,3598
3,2190,20170807,2205,520504,2173,2187,572310,2175,2190,634618,796403.33,363638,-109568,-1,-114114,-4546
37,2229,20170808,2232,500088,2188,2192,568112,2190,2211,593722,1007945.44,455882,-114114,0,-93634,20480
10,2242,20170809,2246,490932,2221,2232,587398,2211,2232,584558,854469.38,382786,-93634,0,-93626,8
11,2252,20170810,2259,510312,2234,2241,604034,2232,2247,609430,1012502.43,450572,-93626,-1,-99118,-5492
-78,2177,20170811,2278,551866,2165,2255,663194,2247,2207,626598,1936163.54,877206,-99118,1,-74732,24386
-20,2166,20170814,2188,548908,2151,2186,692638,2207,2169,635522,849247.57,391512,-74732,0,-86614,-11882
-5,2157,20170815,2174,548112,2152,2162,731398,2169,2165,638362,815791.71,376796,-86614,0,-90250,-3636
-12,2140,20170816,2159,584412,2129,2152,799058,2165,2141,679132,890735.35,416010,-90250,0,-94720,-4470
8,2152,20170817,2159,574706,2138,2144,794652,2141,2150,674592,871332.72,405362,-94720,-1,-99886,-5166
-6,2150,20170818,2162,576722,2148,2156,793818,2150,2157,672060,623921.19,289266,-99886,1,-95338,4548
18,2165,20170821,2176,590062,2147,2147,827528,2157,2163,693760,1066236.44,492950,-95338,-1,-103698,-8360
23,2184,20170822,2186,575408,2130,2161,820716,2163,2165,677410,1613078.82,744928,-103698,0,-102002,1696
3,2182,20170823,2194,589576,2171,2179,841822,2165,2184,687172,1431813.65,655714,-102002,0,-97596,4406
-12,2176,20170824,2190,578762,2161,2188,827362,2184,2174,679326,1152666.59,530238,-97596,0,-100564,-2968
-1,2177,20170825,2185,572054,2167,2178,827392,2174,2178,677316,854618.11,392312,-100564,0,-105262,-4698
12,2194,20170828,2205,583826,2170,2182,839476,2178,2189,681106,1309070.85,597970,-105262,0,-97280,7982
-21,2177,20170829,2199,593724,2170,2198,854950,2189,2181,703122,956938.12,438820,-97280,0,-109398,-12118
-14,2155,20170830,2179,613456,2148,2169,881558,2181,2166,720520,1040000.58,480218,-109398,1,-107064,2334
-5,2151,20170831,2161,604996,2145,2156,888986,2166,2154,713218,695957.85,323138,-107064,0,-108222,-1158
3,2153,20170901,2168,615230,2140,2150,898074,2154,2159,728502,917365.49,424936,-108222,-1,-113272,-5050
6,2166,20170904,2174,604540,2147,2160,895912,2159,2161,722812,1203035.82,556814,-113272,-1,-118272,-5000
6,2170,20170905,2180,613910,2162,2164,914330,2161,2172,732382,917645.7,422546,-118272,-1,-118472,-200
2,2177,20170906,2194,617516,2170,2175,906874,2172,2181,740968,1207303,553508,-118472,-1,-123452,-4980
12,2192,20170907,2202,629880,2170,2180,918346,2181,2184,740944,1272087.94,582486,-123452,0,-111064,12388
-31,2163,20170908,2199,642206,2152,2194,907006,2184,2179,740390,1369483.82,628578,-111064,1,-98184,12880
8,2172,20170911,2177,615880,2150,2164,866706,2179,2165,714614,837460.75,386886,-98184,-1,-98734,-550
-4,2166,20170912,2183,643168,2157,2170,898290,2165,2171,738062,885096.91,407688,-98734,1,-94894,3840
-43,2123,20170913,2179,715294,2112,2166,1015814,2171,2143,805404,2114066.23,986520,-94894,1,-90110,4784
20,2146,20170914,2147,659644,2121,2126,914608,2143,2135,739490,1007122.66,471810,-90110,0,-79846,10264
13,2159,20170915,2169,655932,2143,2146,888886,2135,2159,739842,1265522.85,586120,-79846,-1,-83910,-4064
14,2172,20170918,2175,627058,2138,2158,837148,2159,2158,696588,1078364.14,499770,-83910,0,-69530,14380
-11,2157,20170919,2180,631754,2155,2168,827314,2158,2167,698934,835111.92,385438,-69530,1,-67180,2350
4,2162,20170920,2165,635134,2145,2158,817076,2167,2155,711190,669983.83,310862,-67180,-1,-76056,-8876
24,2184,20170921,2188,694170,2152,2160,876814,2155,2170,750032,1262441.29,581714,-76056,0,-55862,20194
64,2248,20170922,2258,791120,2175,2184,993994,2170,2221,820734,2710342.11,1220566,-55862,0,-29614,26248
7,2258,20170925,2270,769000,2237,2251,950030,2221,2254,806764,1673730.61,742718,-29614,-1,-37764,-8150
-11,2244,20170926,2258,773194,2229,2255,973792,2254,2241,819506,1139918.76,508612,-37764,0,-46312,-8548
4,2243,20170927,2246,797368,2218,2239,989140,2241,2231,837092,1075011.56,481808,-46312,0,-39724,6588
-18,2220,20170928,2251,769176,2208,2238,937656,2231,2231,799380,1290363.01,578416,-39724,1,-30204,9520
-41,2174,20170929,2237,673264,2161,2215,781648,2231,2202,725530,1546124.43,702100,-30204,0,-52266,-22062
1,2213,20171009,2230,632226,2202,2212,739160,2202,2216,694522,622026.73,280676,-52266,-1,-62296,-10030
-2,2213,20171010,2225,656788,2206,2215,768314,2216,2215,711278,729852.34,329536,-62296,1,-54490,7806
-13,2207,20171011,2236,696954,2199,2220,820224,2215,2217,749650,1080756.54,487514,-54490,1,-52696,1794
-3,2204,20171012,2218,691302,2196,2207,810670,2217,2208,741846,700008.99,317074,-52696,1,-50544,2152
78,2284,20171013,2285,752026,2198,2206,897946,2208,2257,796696,1609465.78,713040,-50544,0,-44670,5874
-12,2276,20171016,2292,738972,2267,2288,883508,2257,2279,789042,1085192.66,476092,-44670,0,-50070,-5400
-9,2269,20171017,2295,762448,2260,2278,899318,2279,2276,817752,821213.27,360826,-50070,0,-55304,-5234
1,2264,20171018,2275,733224,2258,2263,866624,2276,2267,790386,755740.67,333418,-55304,-1,-57162,-1858
8,2275,20171019,2280,732072,2257,2267,858548,2267,2271,769158,917891.43,404176,-57162,0,-37086,20076
-4,2273,20171020,2283,731630,2264,2277,833044,2271,2272,769564,807864.25,355508,-37086,0,-37934,-848
-26,2249,20171023,2298,772234,2236,2275,880314,2272,2262,796110,1251939.28,553386,-37934,1,-23876,14058
-6,2242,20171024,2257,737596,2240,2248,832488,2262,2248,768412,530638.6,236076,-23876,0,-30816,-6940
14,2254,20171025,2257,736084,2233,2240,829210,2248,2247,772950,644780.48,286972,-30816,-1,-36866,-6050
-32,2224,20171026,2262,722786,2220,2256,816304,2247,2240,772816,925284.21,413100,-36866,0,-50030,-13164
-19,2209,20171027,2235,689124,2205,2228,769878,2240,2220,743380,706420.8,318250,-50030,0,-54256,-4226
5,2216,20171030,2226,683482,2209,2211,762214,2220,2217,746884,571140.61,257596,-54256,-1,-63402,-9146
-24,2192,20171031,2219,699036,2191,2216,777916,2217,2202,749520,634242.03,287980,-63402,1,-50484,12918
4,2199,20171101,2208,676524,2187,2195,744798,2202,2199,723030,564385.69,256698,-50484,0,-46506,3978
10,2207,20171102,2220,673894,2189,2197,733798,2199,2207,720762,717760.19,325274,-46506,-1,-46868,-362
-3,2202,20171103,2216,662278,2199,2205,725382,2207,2207,724026,614949.53,278574,-46868,0,-61748,-14880
-9,2193,20171106,2205,667596,2180,2202,747356,2207,2191,735712,756333.93,345264,-61748,0,-68116,-6368
22,2215,20171107,2219,651508,2191,2193,693280,2191,2206,724578,1008697.36,457336,-68116,-1,-73070,-4954
12,2222,20171108,2231,648636,2209,2210,679030,2206,2221,735104,1022052.18,460254,-73070,-1,-86468,-13398
14,2236,20171109,2238,651326,2212,2222,667352,2221,2225,734104,848641.56,381424,-86468,0,-82778,3690
-31,2206,20171110,2245,633426,2199,2237,660572,2225,2218,723696,1115303.74,502810,-82778,0,-90270,-7492
21,2227,20171113,2230,634138,2204,2206,631056,2218,2218,727110,741546.42,334380,-90270,-1,-92972,-2702
4,2226,20171114,2243,614252,2217,2222,614012,2218,2229,710876,1054608.61,473100,-92972,-1,-96624,-3652
29,2256,20171115,2271,619298,2226,2227,642344,2229,2253,700282,2426663.02,1077308,-96624,0,-80984,15640
24,2284,20171116,2295,645222,2252,2260,648102,2253,2271,696908,1604688.56,706652,-80984,0,-51686,29298
-4,2277,20171117,2297,650630,2272,2281,641116,2271,2281,702540,1404139.47,615658,-51686,0,-51910,-224
45,2328,20171120,2339,683674,2267,2283,668146,2281,2310,706592,1755497.2,759988,-51910,0,-22918,28992
19,2343,20171121,2354,684772,2316,2324,677908,2310,2333,709096,1367300.62,586098,-22918,-1,-24324,-1406
-14,2327,20171122,2346,680600,2310,2341,651758,2333,2327,717514,1273527.75,547398,-24324,0,-36914,-12590
-16,2319,20171123,2344,661682,2317,2335,593354,2327,2330,706416,1115204.94,478686,-36914,0,-44734,-7820
14,2333,20171124,2339,676870,2317,2319,591530,2330,2328,711218,622777.25,267546,-44734,0,-34348,10386
-26,2310,20171127,2346,677252,2305,2336,576002,2328,2327,712800,1163291.57,499946,-34348,0,-35548,-1200
1,2314,20171128,2326,671984,2304,2313,564616,2327,2315,708954,675799.87,291926,-35548,-1,-36970,-1422
3,2311,20171129,2321,655090,2299,2308,541036,2315,2310,704380,671520.08,290704,-36970,-1,-49290,-12320
-11,2301,20171130,2325,629250,2296,2312,504250,2310,2310,689006,874842.23,378666,-49290,0,-59756,-10466
-21,2281,20171201,2302,570408,2277,2302,448426,2310,2288,637234,827660.4,361814,-59756,0,-66826,-7070
58,2341,20171204,2351,592962,2283,2283,441468,2288,2320,653546,888090.28,382824,-66826,0,-60584,6242
-7,2352,20171205,2366,573414,2345,2359,431234,2333,2354,648636,504424.54,214314,-60584,0,-75222,-14638
35,2394,20171206,2404,570764,2358,2359,485442,2354,2387,643196,1147739.56,480852,-75222,0,-72432,2790
-27,2373,20171207,2400,563132,2366,2400,512396,2387,2384,630558,1158615.12,486054,-72432,1,-67426,5006
7,2367,20171208,2372,549986,2347,2360,532282,2384,2361,610986,1061734.14,449762,-67426,0,-61000,6426
-23,2347,20171211,2380,519774,2335,2370,529436,2361,2353,588544,866033.64,368028,-61000,0,-68770,-7770
5,2345,20171212,2359,525276,2337,2340,554744,2353,2348,591132,751435.16,319966,-68770,0,-65856,2914
9,2350,20171213,2363,519854,2330,2341,576734,2348,2348,580738,982065.84,418170,-65856,0,-60884,4972
-22,2326,20171214,2357,491210,2323,2348,559560,2348,2341,564358,891193.5,380756,-60884,0,-73148,-12264
-1,2324,20171215,2338,489460,2320,2325,560370,2341,2328,567154,728801.15,313040,-73148,0,-77694,-4546
9,2339,20171218,2342,492010,2322,2330,591642,2328,2331,572716,809980.53,347492,-77694,-1,-80706,-3012
-9,2333,20171219,2361,468216,2329,2342,588998,2331,2343,561050,1116233.21,476504,-80706,0,-92834,-12128
-18,2315,20171220,2343,472602,2308,2333,593406,2343,2323,561370,945481.36,407048,-92834,1,-88768,4066
-16,2300,20171221,2322,469764,2297,2316,591662,2323,2312,549480,811447.4,350976,-88768,1,-79716,9052
-1,2299,20171222,2307,462592,2292,2300,595824,2312,2301,545744,607104.55,263838,-79716,0,-83152,-3436
-4,2304,20171225,2318,484688,2297,2308,593648,2301,2309,568348,684916.84,296676,-83152,0,-83660,-508
28,2328,20171226,2334,544272,2300,2300,603238,2309,2320,614020,850419.74,366516,-83660,0,-69748,13912
7,2336,20171227,2341,545888,2321,2329,612128,2320,2333,619202,735732.19,315396,-69748,-1,-73314,-3566
-6,2327,20171228,2339,565410,2318,2333,592822,2333,2328,629556,699046.26,300304,-73314,1,-64146,9168
-34,2290,20171229,2334,556886,2285,2324,597038,2328,2310,626524,1153830.95,499556,-64146,0,-69638,-5492
-14,2288,20180102,2306,565086,2279,2302,606340,2310,2291,652744,632713.23,276174,-69638,0,-87658,-18020
4,2294,20180103,2303,562022,2288,2290,608344,2291,2295,657986,761093.01,331632,-87658,-1,-95964,-8306
-14,2283,20180104,2298,575142,2276,2297,625648,2295,2288,675796,939508.78,410686,-95964,0,-100654,-4690
11,2293,20180105,2302,560620,2271,2282,614906,2288,2287,675166,1131521.86,494790,-100654,-1,-114546,-13892
-19,2280,20180108,2301,572098,2280,2299,612182,2287,2289,680930,811651.53,354590,-114546,1,-108832,5714
11,2296,20180109,2311,580684,2284,2285,609004,2289,2300,695854,1139073.37,495240,-108832,-1,-115170,-6338
-6,2287,20180110,2303,599824,2283,2293,627854,2300,2292,710468,879508.44,383704,-115170,1,-110644,4526
-16,2270,20180111,2293,610874,2263,2286,653666,2292,2275,729826,1033118.98,454168,-110644,0,-118952,-8308
-26,2246,20180112,2274,627502,2243,2272,674188,2275,2256,744120,907198.03,402038,-118952,1,-116618,2334
23,2270,20180115,2279,602466,2241,2247,646858,2256,2263,718888,861957.71,380952,-116618,0,-116422,196
-2,2269,20180116,2275,615806,2262,2271,649808,2263,2269,730592,650846.75,286852,-116422,1,-114786,1636
8,2280,20180117,2285,614276,2267,2272,649644,2269,2279,734458,892716.5,391752,-114786,-1,-120182,-5396
-6,2275,20180118,2286,614140,2269,2281,664428,2279,2277,741066,727162.29,319286,-120182,0,-126926,-6744
20,2294,20180119,2298,616166,2268,2274,684942,2277,2288,731276,1260257.3,550706,-126926,0,-115110,11816
0,2302,20180122,2306,595248,2293,2302,685606,2288,2300,710732,799194.55,347478,-115110,0,-115484,-374
-3,2305,20180123,2314,577346,2297,2308,673756,2300,2305,682376,786701.41,341270,-115484,1,-105030,10454
-24,2283,20180124,2309,577604,2281,2307,672672,2305,2293,675416,934650.09,407674,-105030,1,-97812,7218
30,2315,20180125,2321,605478,2283,2285,702932,2293,2304,709620,1125534.96,488486,-97812,-1,-104142,-6330
-17,2298,20180126,2317,593584,2287,2315,686806,2304,2304,698448,1005501.54,436468,-104142,0,-104864,-722
43,2340,20180129,2342,626282,2295,2297,736776,2304,2321,731978,1487879.35,640942,-104864,-1,-105696,-832
3,2343,20180130,2350,660114,2325,2340,765688,2321,2336,770122,1227844.89,525670,-105696,-1,-110008,-4312
-1,2345,20180131,2353,657432,2332,2346,750854,2336,2344,759538,1032852.95,440646,-110008,1,-102106,7902
3,2338,20180201,2344,677898,2326,2335,767900,2344,2334,780082,974784.39,417636,-102106,-1,-102184,-78
-23,2311,20180202,2337,665756,2308,2334,740180,2334,2322,779310,1116212.84,480784,-102184,0,-113554,-11370
0,2313,20180205,2324,657872,2304,2313,727818,2322,2313,776180,971541.48,420124,-113554,0,-118308,-4754
-5,2303,20180206,2318,648258,2300,2308,716698,2313,2308,763136,866103.59,375222,-118308,1,-114878,3430
23,2335,20180207,2342,661776,2309,2312,735226,2308,2328,795486,1380702.04,592962,-114878,-1,-133710,-18832
11,2338,20180208,2340,653672,2324,2327,714578,2328,2331,780798,788196.05,338152,-133710,0,-127126,6584
-9,2334,20180209,2346,637930,2331,2343,678470,2331,2338,762028,804060.84,343900,-127126,1,-124098,3028
45,2380,20180212,2381,645872,2332,2335,719488,2338,2360,770660,1306693.89,553734,-124098,-1,-124788,-690
-4,2371,20180213,2389,614246,2370,2375,648932,2360,2378,725600,836610.78,351772,-124788,1,-111354,13434
5,2380,20180214,2388,608294,2375,2375,621236,2378,2381,708932,529186.24,222234,-111354,0,-100638,10716
4,2464,20180222,2472,626144,2435,2460,642430,2381,2457,714508,779959.52,317436,-100638,0,-88364,12274
-1,2461,20180223,2465,655140,2454,2462,685542,2457,2460,756884,834147.55,339116,-88364,0,-101744,-13380
-2,2466,20180226,2485,683194,2462,2468,698702,2460,2472,773856,1181592.97,477940,-101744,1,-90662,11082
-10,2463,20180227,2479,688474,2456,2473,682228,2472,2467,765842,950083.19,385084,-90662,1,-77368,13294
23,2493,20180228,2500,703380,2461,2470,708234,2467,2484,760398,1303121.68,524708,-77368,0,-57018,20350
11,2506,20180301,2508,722156,2477,2495,730554,2484,2493,758570,1382867.58,554608,-57018,0,-36414,20604
83,2578,20180302,2613,744192,2492,2495,753440,2493,2557,759808,3502187.86,1369656,-36414,0,-15616,20798
-8,2570,20180305,2598,710716,2556,2578,713304,2557,2574,740650,2258671.57,877516,-15616,0,-29934,-14318
-11,2565,20180306,2581,708040,2545,2576,704254,2574,2564,734934,1670997.74,651644,-29934,1,-26894,3040
-15,2553,20180307,2579,717056,2542,2568,697780,2564,2560,747772,2191776.84,856306,-26894,0,-30716,-3822
1,2548,20180308,2561,715676,2534,2547,687282,2560,2548,746826,1627419.02,638694,-30716,-1,-31150,-434
-6,2537,20180309,2570,705632,2520,2543,663334,2548,2548,734268,2365655.82,928606,-31150,1,-28636,2514
-18,2517,20180312,2536,698868,2502,2535,650228,2548,2517,723412,1874323.08,744650,-28636,1,-24544,4092
3,2517,20180313,2537,693558,2509,2514,631986,2517,2523,715696,1416075.56,561376,-24544,0,-22138,2406
8,2525,20180314,2536,698000,2513,2517,628090,2523,2524,725268,1237098.49,490040,-22138,-1,-27268,-5130
-33,2494,20180315,2530,666898,2485,2527,588876,2524,2503,710184,1375129.7,549466,-27268,0,-43286,-16018
7,2510,20180316,2514,662782,2487,2503,562160,2503,2500,687674,1558602.73,623510,-43286,0,-24892,18394
-23,2484,20180319,2523,640834,2479,2507,530530,2500,2501,677174,1452170.11,580570,-24892,0,-36340,-11448
-1,2477,20180320,2487,641424,2467,2478,503414,2501,2477,674498,1099835.97,444016,-36340,1,-33074,3266
0,2475,20180321,2490,639200,2469,2475,493822,2477,2478,675370,826536.21,333510,-33074,0,-36170,-3096
-20,2461,20180322,2486,630382,2459,2481,478446,2478,2475,681120,1021647.03,412786,-36170,0,-50738,-14568
42,2502,20180323,2553,626856,2457,2460,435112,2475,2497,688592,2180654.63,873218,-50738,-1,-61736,-10998
32,2530,20180326,2554,629948,2465,2498,468780,2508,2517,709152,1183590.67,470220,-61736,-1,-79204,-17468
-31,2497,20180327,2535,632324,2483,2528,498534,2517,2505,711676,771292.74,307852,-79204,0,-79352,-148
-4,2496,20180328,2510,638656,2489,2500,520622,2505,2499,726732,735122.67,294206,-79352,0,-88076,-8724
-21,2473,20180329,2496,624646,2468,2494,517484,2499,2478,709626,723976.66,292166,-88076,1,-84980,3096
100,2573,20180330,2599,612796,2469,2473,566738,2478,2549,702258,1791804.7,702926,-84980,-1,-89462,-4482
19,2589,20180402,2614,614304,2565,2570,600142,2549,2587,697444,1342683.03,519022,-89462,0,-83140,6322
-11,2578,20180403,2595,610518,2561,2589,609022,2587,2578,696608,1452067.95,563184,-83140,0,-86090,-2950
43,2623,20180404,2624,602822,2576,2580,618374,2578,2603,669532,2149212.38,825642,-86090,0,-66710,19380
-22,2712,20180409,2734,562540,2683,2734,616094,2603,2722,636118,3586817.77,1317936,-66710,0,-73578,-6868
-24,2686,20180410,2721,563138,2662,2710,638392,2722,2695,641180,3067527.93,1138280,-73578,0,-78042,-4464
5,2686,20180411,2690,567612,2657,2681,646494,2695,2675,651816,1973456.56,737742,-78042,-1,-84204,-6162
-24,2663,20180412,2690,559856,2657,2687,629258,2675,2673,639574,1521364.18,569148,-84204,1,-79718,4486
14,2675,20180413,2697,570490,2653,2661,646698,2673,2676,653534,1736760.61,648932,-79718,-1,-83044,-3326
-10,2660,20180416,2675,575480,2637,2670,658240,2676,2659,669408,1493704.95,561710,-83044,0,-93928,-10884
31,2697,20180417,2706,583970,2630,2666,683442,2659,2659,684566,2132160.21,801958,-93928,-1,-100596,-6668
-30,2664,20180418,2695,586412,2646,2694,676158,2659,2666,688180,2092711.13,785050,-100596,0,-101768,-1172
-11,2657,20180419,2670,581420,2643,2668,668304,2666,2656,680712,1511867.25,569276,-101768,1,-99292,2476
13,2664,20180420,2676,582958,2650,2651,664418,2656,2664,673088,1599567.2,600428,-99292,0,-90130,9162
-3,2653,20180423,2680,584306,2634,2656,655938,2664,2654,671582,1792862.61,675516,-90130,1,-87276,2854
-6,2645,20180424,2658,591470,2642,2651,659460,2654,2648,674054,1158916.5,437596,-87276,1,-82584,4692
21,2662,20180425,2692,619598,2636,2641,685602,2648,2666,693922,2312573.69,867428,-82584,0,-74324,8260
-13,2650,20180426,2676,629042,2642,2663,689944,2666,2658,718944,1656561.83,623248,-74324,0,-89902,-15578
-5,2646,20180427,2660,634334,2621,2651,677034,2658,2641,707894,1942189.02,735410,-89902,1,-73560,16342
-6,2676,20180502,2697,606938,2665,2682,658806,2641,2683,700982,1151774.47,429250,-73560,0,-94044,-20484
6,2680,20180503,2687,608442,2663,2674,654740,2683,2675,694790,1170446.74,437566,-94044,0,-86348,7696
-25,2650,20180504,2682,620176,2633,2675,653624,2675,2658,706346,1526560.22,574250,-86348,1,-86170,178
-25,2623,20180507,2670,622460,2616,2648,651334,2658,2649,710470,1564642.01,590572,-86170,0,-88010,-1840
-64,2559,20180508,2627,633808,2551,2623,669128,2649,2583,711514,2029971.02,785812,-88010,1,-77706,10304
-4,2561,20180509,2572,629502,2554,2565,661340,2583,2564,713592,1123915.22,438428,-77706,0,-84090,-6384
18,2573,20180510,2578,638812,2547,2555,670414,2564,2563,717924,1131927.13,441630,-84090,0,-79112,4978
-46,2528,20180511,2575,641400,2520,2574,677516,2563,2544,732018,1411731.88,554876,-79112,0,-90618,-11506
-24,2500,20180514,2537,628048,2494,2524,667110,2544,2520,719734,1433347.88,568886,-90618,0,-91686,-1068
-9,2495,20180515,2525,615986,2487,2504,663480,2520,2507,726554,1401064.23,558946,-91686,0,-110568,-18882
-49,2444,20180516,2497,601016,2404,2493,635354,2507,2445,709962,2377080.69,972078,-110568,1,-108946,1622
1,2445,20180517,2465,578166,2423,2444,615122,2445,2446,699100,2122481.89,867776,-108946,-1,-120934,-11988
-2,2444,20180518,2456,582136,2412,2446,620518,2446,2438,709742,1573949.25,645458,-120934,0,-127606,-6672
3,2443,20180521,2470,587792,2420,2440,642954,2438,2446,729300,1985429.01,811808,-127606,-1,-141508,-13902
-1,2441,20180522,2458,580860,2427,2442,634752,2446,2443,724798,1334203.25,546066,-141508,0,-143938,-2430
25,2475,20180523,2489,598752,2445,2450,661170,2443,2467,736426,2188014.49,886784,-143938,0,-137674,6264
58,2533,20180524,2537,621730,2472,2475,687612,2467,2504,746146,2595356.81,1036686,-137674,0,-124416,13258
-16,2516,20180525,2539,606062,2507,2532,652896,2504,2520,734382,1534599.05,608906,-124416,0,-128320,-3904
5,2526,20180528,2538,596086,2512,2521,651918,2520,2525,736042,1323692.85,524132,-128320,-1,-139956,-11636
34,2559,20180529,2564,615422,2522,2525,651102,2525,2546,737414,1706065.97,669988,-139956,0,-121992,17964
-14,2531,20180530,2552,622320,2518,2545,631438,2546,2536,749360,2205466.2,869750,-121992,0,-127040,-5048
-25,2505,20180531,2533,630670,2486,2530,628426,2536,2507,763682,2074542.77,827636,-127040,0,-133012,-5972
-12,2498,20180601,2520,620806,2496,2510,620460,2507,2509,755728,1356633.57,540792,-133012,0,-134922,-1910
8,2506,20180604,2518,616184,2481,2498,621288,2509,2499,745824,1786745.89,715068,-134922,0,-129640,5282
-26,2480,20180605,2516,614798,2452,2506,619548,2499,2487,735692,2071077.14,832910,-129640,1,-120894,8746
1,2481,20180606,2487,604308,2468,2480,611598,2487,2478,726844,1129891.76,456052,-120894,-1,-122536,-1642
-16,2459,20180607,2480,608360,2444,2475,620338,2478,2464,740062,1270362.57,515598,-122536,0,-131702,-9166
-84,2379,20180608,2468,636330,2343,2463,668132,2464,2393,761172,3021766,1262504,-131702,1,-124842,6860
-14,2370,20180611,2395,615762,2364,2384,653018,2393,2380,749570,1668653.57,701252,-124842,0,-133808,-8966
2,2367,20180612,2377,606884,2358,2365,651448,2380,2369,753690,1537572.83,648998,-133808,-1,-146806,-12998
13,2379,20180613,2391,612780,2343,2366,645118,2369,2372,770128,2018540.86,850856,-146806,-1,-157348,-10542
9,2384,20180614,2394,593382,2371,2375,627576,2372,2384,760410,1683828.81,706196,-157348,-1,-167028,-9680
-1,2380,20180615,2407,573542,2363,2381,596072,2384,2385,741314,2121876.47,889538,-167028,0,-167772,-744
-16,2454,20180619,2497,546698,2433,2470,532086,2385,2461,714272,2698145.43,1096166,-167772,1,-167574,198
-4,2451,20180620,2467,541208,2426,2455,522670,2461,2451,705248,1800774.63,734758,-167574,1,-164040,3534
-13,2440,20180621,2459,541636,2428,2453,513080,2451,2446,707844,1351379.46,552446,-164040,0,-166208,-2168
-64,2380,20180622,2448,559542,2365,2444,527326,2446,2400,718530,1851254.84,771304,-166208,1,-158988,7220
18,2407,20180625,2413,542412,2384,2389,500364,2400,2399,689440,1181224.51,492302,-158988,0,-147028,11960
28,2439,20180626,2454,528060,2396,2411,484112,2399,2426,677090,1914570.37,789178,-147028,-1,-149030,-2002
48,2489,20180627,2505,529644,2426,2441,499650,2426,2461,673390,2441547.69,991948,-149030,0,-143746,5284
-6,2489,20180628,2498,515892,2462,2495,475736,2461,2485,659466,1849766.69,744412,-143746,1,-143574,172
38,2532,20180629,2535,514224,2489,2494,472566,2485,2517,646098,2405955.96,956026,-143574,0,-131874,11700
53,2588,20180702,2604,541736,2521,2535,508166,2517,2570,665922,3179843.35,1237286,-131874,0,-124186,7688
-13,2569,20180703,2589,538966,2540,2582,485266,2570,2569,666330,2670286.17,1039312,-124186,0,-127364,-3178
-34,2538,20180704,2578,526846,2523,2572,461288,2569,2553,662530,2858571.72,1119836,-127364,0,-135684,-8320
15,2553,20180705,2563,547900,2511,2538,478360,2553,2540,677994,2602182.01,1024414,-135684,0,-130094,5590
-6,2545,20180706,2577,549200,2501,2551,446122,2540,2545,680980,4199699.72,1649876,-130094,0,-131780,-1686
-21,2537,20180709,2577,551476,2528,2558,450048,2545,2549,683198,2840478.65,1114170,-131780,1,-131722,58
-8,2527,20180710,2535,590316,2504,2535,461968,2549,2518,713154,2524638.67,1002478,-131722,1,-122838,8884
-16,2516,20180711,2558,619522,2510,2532,459360,2518,2535,752408,2461901.75,971354,-122838,0,-132886,-10048
-18,2502,20180712,2530,619648,2487,2520,448380,2535,2510,752572,2243743.93,893750,-132886,0,-132924,-38
-13,2490,20180713,2507,617924,2478,2503,437962,2510,2495,748312,1554447.11,623116,-132924,1,-130388,2536
18,2508,20180716,2512,635138,2481,2490,448730,2495,2495,759104,1564330.4,626942,-130388,0,-123966,6422
28,2534,20180717,2544,644532,2505,2506,441780,2495,2528,768670,1830002.02,724010,-123966,-1,-124138,-172
-32,2500,20180718,2538,629074,2500,2532,435030,2528,2521,766488,1619352.5,642364,-124138,0,-137414,-13276
14,2518,20180719,2520,634170,2486,2504,407492,2521,2500,751740,1840653.36,736342,-137414,0,-117570,19844
4,2524,20180720,2547,625784,2517,2520,389548,2500,2530,736254,1890796.59,747294,-117570,0,-110470,7100
-9,2513,20180723,2538,639316,2508,2522,390258,2530,2521,754466,1415388.75,561462,-110470,0,-115150,-4680
8,2520,20180724,2521,650774,2493,2512,371036,2521,2509,771014,1544197,615358,-115150,-1,-120240,-5090
16,2491,20180725,2500,647666,2473,2475,380536,2463,2489,771014,553497.38,222352,-120240,-1,-123348,-3108
22,2514,20180726,2520,650814,2480,2492,402400,2489,2504,770478,626315.72,250110,-123348,0,-119664,3684
-25,2492,20180727,2520,646960,2487,2517,407932,2504,2499,776190,628559.1,251476,-119664,0,-129230,-9566
28,2522,20180730,2527,653152,2491,2494,418528,2499,2513,761586,654169.24,260360,-129230,0,-108434,20796
-6,2516,20180731,2534,659616,2508,2522,426174,2513,2522,763374,632344.35,250720,-108434,1,-103758,4676
-60,2466,20180801,2533,645976,2458,2526,423038,2522,2486,758664,1313005.56,528080,-103758,0,-112688,-8930
8,2476,20180802,2485,640410,2466,2468,427726,2486,2474,735126,649875.38,262648,-112688,0,-94716,17972
-40,2437,20180803,2488,626428,2435,2477,443300,2474,2456,733598,1085503.1,441900,-94716,0,-107170,-12454
40,2480,20180806,2482,602706,2427,2440,438428,2456,2463,697564,1102481.93,447684,-107170,0,-94858,12312
28,2501,20180807,2510,592798,2472,2473,459570,2463,2493,684618,1380228.8,553556,-94858,0,-91820,3038
41,2544,20180808,2556,590350,2492,2503,498582,2493,2516,692376,2088567.47,830002,-91820,-1,-102026,-10206
-2,2544,20180809,2569,581794,2540,2546,512844,2516,2553,685136,2318284.39,907966,-102026,0,-103342,-1316
3,2549,20180810,2565,584522,2531,2546,526940,2553,2547,680726,1699134.16,667066,-103342,0,-96204,7138
-62,2489,20180813,2575,577140,2460,2551,509376,2547,2516,666800,2064643.11,820668,-96204,1,-89660,6544
42,2534,20180814,2538,580786,2486,2492,520740,2516,2520,670596,1653603.12,656148,-89660,-1,-89810,-150
7,2557,20180815,2563,579112,2535,2550,533122,2520,2551,667482,1728353.27,677464,-89810,0,-88370,1440
-33,2518,20180816,2567,569990,2503,2551,515644,2551,2532,658542,2672894.5,1055854,-88370,0,-88552,-182
-15,2504,20180817,2531,565930,2492,2519,508146,2532,2517,650812,1688915.11,671092,-88552,1,-84882,3670
-29,2479,20180820,2522,564402,2452,2508,504764,2517,2481,654120,1941325.65,782430,-84882,0,-89718,-4836
-5,2471,20180821,2487,560228,2456,2476,501372,2481,2473,646928,1387732.28,561182,-89718,1,-86700,3018
13,2484,20180822,2500,584804,2453,2471,513984,2473,2475,679234,1817381.08,734406,-86700,-1,-94430,-7730
-72,2410,20180823,2493,591270,2408,2482,537684,2475,2459,702356,2126600.64,864896,-94430,0,-111086,-16656
5,2413,20180824,2427,602458,2398,2408,532186,2459,2416,711328,1493564.67,618262,-111086,0,-108870,2216
-70,2348,20180827,2424,647868,2335,2418,562950,2416,2369,776074,2277058.32,961302,-108870,0,-128206,-19336
7,2356,20180828,2372,649820,2345,2349,551412,2369,2357,768686,1511538.12,641360,-128206,0,-118866,9340
0,2360,20180829,2370,648780,2346,2360,554162,2357,2359,771554,1333025.61,565184,-118866,0,-122774,-3908
18,2385,20180830,2397,657336,2363,2367,544338,2359,2381,770100,1628511.54,683868,-122774,0,-112764,10010
-6,2378,20180831,2390,655472,2358,2384,535262,2381,2376,772366,1473159.7,620116,-112764,0,-116894,-4130
5,2385,20180903,2394,672716,2369,2380,563060,2376,2381,812170,1499595.14,629710,-116894,-1,-139454,-22560
-26,2357,20180904,2387,691642,2341,2383,584960,2381,2357,852892,1878586.52,797082,-139454,0,-161250,-21796
1,2360,20180905,2370,699124,2338,2359,588848,2357,2357,853380,1419166.34,602154,-161250,0,-154256,6994
19,2375,20180906,2379,719340,2345,2356,580556,2357,2361,861228,1191287.15,504468,-154256,0,-141888,12368
-40,2337,20180907,2382,746654,2328,2377,645494,2361,2350,927592,2075621.76,883398,-141888,0,-180938,-39050
47,2386,20180910,2400,753284,2317,2339,629074,2350,2364,919300,2486351.12,1051568,-180938,0,-166016,14922
13,2404,20180911,2418,757324,2383,2391,622818,2364,2401,922496,1971193,820832,-166016,0,-165172,844
-15,2384,20180912,2410,753760,2377,2399,615386,2401,2391,932694,1935504.16,809634,-165172,0,-178934,-13762
-48,2334,20180913,2391,773678,2318,2382,624634,2391,2348,945910,2570607.05,1094714,-178934,1,-172232,6702
5,2344,20180914,2354,762742,2334,2339,592872,2348,2343,920702,1394305.24,595048,-172232,0,-157960,14272
-9,2336,20180917,2368,755922,2326,2345,619968,2343,2347,922386,1677729.36,714760,-157960,0,-166464,-8504
16,2353,20180918,2365,791132,2311,2337,651330,2347,2344,963232,2544255.09,1085580,-166464,-1,-172100,-5636
2,2357,20180919,2361,804500,2333,2355,649762,2344,2349,980460,1578886.86,672142,-172100,-1,-175960,-3860
26,2383,20180920,2398,817382,2354,2357,626010,2349,2380,981986,2121006.49,891366,-175960,0,-164604,11356
5,2390,20180921,2398,827218,2373,2385,612674,2380,2385,982206,1374627.04,576382,-164604,0,-154988,9616
50,2452,20180925,2458,865878,2400,2402,646970,2385,2435,986462,1870556.94,768188,-154988,0,-120584,34404
8,2464,20180926,2473,867040,2447,2456,647300,2435,2459,981546,1710861.63,695732,-120584,0,-114506,6078
24,2487,20180927,2487,860598,2449,2463,639020,2459,2464,968890,1377573.76,559118,-114506,0,-108292,6214
18,2508,20180928,2508,846180,2469,2490,635532,2464,2490,943586,1780139.02,714868,-108292,0,-97406,10886
41,2581,20181008,2587,844122,2538,2540,650456,2490,2558,914926,1328565.06,519426,-97406,0,-70804,26602
30,2609,20181009,2633,871712,2568,2579,704080,2558,2599,942782,2827336.66,1088024,-70804,-1,-71070,-266
19,2623,20181010,2626,889502,2590,2604,727226,2599,2606,941280,2251925.79,864086,-71070,0,-51778,19292
-14,2605,20181011,2642,900748,2583,2619,722760,2606,2613,942328,3058604.9,1170596,-51778,1,-41580,10198
-16,2593,20181012,2626,929506,2573,2609,708692,2613,2596,967024,3420199.13,1317454,-41580,1,-37518,4062
-2,2590,20181015,2609,938852,2577,2592,713352,2596,2593,972454,2402367.22,926382,-37518,1,-33602,3916
2,2593,20181016,2629,908888,2574,2591,725638,2593,2599,944310,3539421.24,1361702,-33602,-1,-35422,-1820
-9,2580,20181017,2592,900320,2548,2589,697480,2599,2568,944390,2955334.88,1150894,-35422,0,-44070,-8648
-13,2567,20181018,2597,893594,2560,2580,696304,2568,2578,935172,2414419.54,936728,-44070,1,-41578,2492
8,2570,20181019,2577,891010,2542,2562,685696,2578,2562,936636,1997019.85,779586,-41578,-1,-45626,-4048
-62,2511,20181022,2573,890618,2506,2573,701988,2562,2533,988440,2646754.63,1044844,-45626,0,-97822,-52196
0,2505,20181023,2524,886434,2503,2505,690636,2533,2515,966264,1459680.32,580470,-97822,0,-79830,17992
33,2534,20181024,2535,892516,2501,2501,693744,2515,2519,973478,1766115.11,701144,-79830,-1,-80962,-1132
-19,2514,20181025,2534,880936,2510,2533,681362,2519,2522,972056,1665455.29,660458,-80962,0,-91120,-10158
48,2558,20181026,2559,922744,2491,2510,720044,2522,2520,991750,2837910.56,1126132,-91120,0,-69006,22114
-17,2543,20181029,2574,922902,2528,2560,723400,2520,2551,996768,3179872.04,1246648,-69006,0,-73866,-4860
-57,2482,20181030,2546,883544,2472,2539,680658,2551,2507,985972,3079733.07,1228318,-73866,0,-102428,-28562
12,2494,20181031,2499,860158,2478,2482,659644,2507,2488,945906,1578562.42,634458,-102428,0,-85748,16680
-37,2460,20181101,2503,838504,2439,2497,618152,2488,2470,932930,2437696,987008,-85748,0,-94426,-8678
-110,2346,20181102,2478,791854,2346,2456,535782,2470,2398,897612,3946926.34,1645716,-94426,0,-105758,-11332
38,2378,20181105,2396,767638,2332,2340,460262,2398,2373,833900,2645117.04,1114808,-105758,0,-66262,39496
-2,2378,20181106,2398,792196,2366,2380,478068,2373,2385,860706,1751005.42,734084,-66262,0,-68510,-2248
17,2393,20181107,2410,787194,2362,2376,470908,2385,2382,857716,2188198.43,918448,-68510,-1,-70522,-2012
-61,2335,20181108,2397,800124,2283,2396,489146,2382,2346,901288,2728188.77,1162716,-70522,0,-101164,-30642
-5,2326,20181109,2339,805720,2311,2331,485604,2346,2322,906800,1551598.2,668254,-101164,1,-101080,84
1,2326,20181112,2335,806372,2308,2325,476752,2322,2324,898970,1506441.62,648248,-101080,0,-92598,8482
-3,2326,20181113,2340,796492,2289,2329,465926,2324,2314,885958,1942460.85,839534,-92598,1,-89466,3132
-10,2316,20181114,2327,789288,2295,2326,458010,2314,2314,876964,1322778.09,571590,-89466,1,-87676,1790
-29,2285,20181115,2325,766188,2264,2314,447058,2314,2290,841018,2115884.25,923940,-87676,1,-74830,12846
69,2356,20181116,2364,754454,2283,2287,423054,2290,2333,810912,2530016.42,1084438,-74830,0,-56458,18372
-10,2347,20181119,2362,737414,2339,2357,413686,2333,2348,801192,1385011.7,589814,-56458,0,-63778,-7320
-6,2336,20181120,2352,734436,2304,2342,404540,2348,2331,799518,2066960.85,886828,-63778,0,-65082,-1304
37,2381,20181121,2383,751436,2317,2344,411698,2331,2353,791278,2289001.52,972956,-65082,0,-39842,25240
-15,2363,20181122,2382,754876,2347,2378,394178,2353,2362,809768,1420924.38,601664,-39842,0,-54892,-15050
-45,2316,20181123,2368,741144,2289,2361,379220,2362,2332,806692,2074035.2,889320,-54892,0,-65548,-10656
-70,2207,20181126,2282,708084,2192,2277,339774,2291,2240,780110,550641.18,245846,-65548,0,-72026,-6478
-44,2167,20181127,2235,689536,2159,2211,346644,2240,2192,786730,854428.48,389856,-72026,0,-97194,-25168
16,2185,20181128,2196,677800,2162,2169,346158,2192,2182,765014,403432.16,184902,-97194,0,-87214,9980
3,2187,20181129,2207,644298,2178,2184,339242,2182,2192,741912,476897.62,217558,-87214,-1,-97614,-10400
2,2186,20181130,2197,607042,2170,2184,326650,2192,2186,712478,477596.11,218512,-97614,-1,-105436,-7822
20,2203,20181203,2211,581666,2160,2183,333250,2186,2188,681500,955453.24,436666,-105436,0,-99834,5602
-29,2178,20181204,2210,547948,2154,2207,343822,2188,2181,641714,773116.5,354462,-99834,1,-93766,6068
31,2213,20181205,2222,569334,2170,2182,344016,2181,2192,621844,865374.05,394876,-93766,0,-52510,41256
17,2232,20181206,2240,569992,2210,2215,366262,2192,2231,606332,888946.49,398522,-52510,0,-36340,16170
6,2235,20181207,2244,557724,2219,2229,362098,2231,2230,594384,868413.02,389380,-36340,-1,-36660,-320
-26,2210,20181210,2238,525568,2204,2236,364386,2230,2216,560176,909985.53,410718,-36660,1,-34608,2052
1,2216,20181211,2230,517508,2198,2215,363300,2216,2215,554870,906314.93,409180,-34608,-1,-37362,-2754
12,2227,20181212,2234,538184,2191,2215,389062,2215,2217,572004,1220669.42,550688,-37362,0,-33820,3542
-9,2222,20181213,2234,539744,2208,2231,403428,2217,2221,577884,1299198.1,584968,-33820,0,-38140,-4320
-39,2177,20181214,2226,577090,2151,2216,484566,2221,2181,635268,2726192.67,1250076,-38140,0,-58178,-20038
-14,2165,20181217,2185,581256,2156,2179,498124,2181,2171,641808,1412813.91,650652,-58178,0,-60552,-2374
8,2172,20181218,2177,579580,2153,2164,496968,2171,2167,638820,1380346.84,637068,-60552,0,-59240,1312
-1,2171,20181219,2182,591720,2163,2172,497570,2167,2172,649658,1076006.78,495308,-59240,1,-57938,1302
4,2175,20181220,2183,586004,2164,2171,497012,2172,2173,643860,1154472.61,531234,-57938,0,-57856,82
-2,2174,20181221,2187,585806,2163,2176,483592,2173,2175,641826,1194654.91,549212,-57856,1,-56020,1836
-65,2111,20181224,2183,610586,2108,2176,592450,2175,2136,675146,2139235.82,1001464,-56020,0,-64560,-8540
-3,2107,20181225,2121,557862,2093,2110,576842,2136,2109,614242,1522536.58,721928,-64560,1,-56380,8180
-3,2108,20181226,2116,495072,2102,2111,553552,2109,2110,554546,927771.99,439730,-56380,0,-59474,-3094
-11,2102,20181227,2129,468362,2084,2113,552152,2110,2105,529804,1310332.39,622504,-59474,0,-61442,-1968
-8,2097,20181228,2109,414216,2078,2105,509414,2105,2094,487796,1184466.22,565564,-61442,0,-73580,-12138
30,2123,20190102,2129,390338,2093,2093,497888,2094,2116,456710,695317.87,328562,-73580,0,-66372,7208
13,2139,20190103,2144,347044,2117,2126,452780,2116,2131,404962,944113.32,442942,-66372,0,-57918,8454
36,2177,20190104,2179,352366,2138,2141,448888,2131,2162,390600,1416915.41,655322,-57918,0,-38234,19684
-4,2176,20190107,2197,335760,2167,2180,414176,2162,2181,377946,1433384.56,657316,-38234,0,-42186,-3952
-5,2171,20190108,2185,359350,2161,2176,420756,2181,2172,401756,1277821.75,588336,-42186,0,-42406,-220
7,2179,20190109,2189,345254,2166,2172,418692,2172,2176,389188,1209825.05,556074,-42406,-1,-43934,-1528
-7,2170,20190110,2186,338800,2150,2177,418288,2176,2170,376958,1655145.53,762666,-43934,1,-38158,5776
-31,2139,20190111,2173,338222,2135,2170,417396,2170,2151,382472,1326903.62,616930,-38158,0,-44250,-6092
-37,2100,20190114,2144,351282,2094,2137,458666,2151,2115,413624,1669058.3,789056,-44250,0,-62342,-18092
13,2110,20190115,2112,344638,2087,2097,455140,2115,2104,410996,1181165.95,561518,-62342,-1,-66358,-4016
-16,2091,20190116,2114,361420,2071,2107,481544,2104,2092,434204,1954968.72,934498,-66358,0,-72784,-6426
9,2103,20190117,2118,356916,2092,2094,481528,2092,2105,439756,1670617.21,793774,-72784,-1,-82840,-10056
13,2115,20190118,2122,376922,2096,2102,483428,2105,2111,457348,1600094.03,757810,-82840,0,-80426,2414
26,2145,20190121,2152,361684,2112,2119,457198,2111,2131,443656,1921794.52,901858,-80426,-1,-81972,-1546
13,2159,20190122,2161,357846,2126,2146,444586,2131,2143,438718,1968006.89,918130,-81972,0,-80872,1100
-11,2148,20190123,2167,344176,2141,2159,430354,2143,2155,432600,1741430.13,807972,-80872,0,-88424,-7552
13,2158,20190124,2160,339692,2136,2145,424996,2155,2150,425506,1561820.88,726482,-88424,0,-85814,2610
-12,2138,20190125,2153,358318,2118,2150,443214,2150,2135,440758,2095385.39,981516,-85814,1,-82440,3374
-3,2136,20190128,2150,355902,2132,2139,433488,2135,2141,437484,1440719.15,672918,-82440,1,-81582,858
-21,2112,20190129,2140,349318,2103,2133,434120,2141,2117,444348,1596821.52,754368,-81582,0,-95030,-13448
-5,2108,20190130,2122,344008,2101,2113,429292,2117,2113,436668,1275336.68,603544,-95030,1,-92660,2370
21,2133,20190131,2143,336182,2109,2112,401748,2113,2122,426644,1346600.2,634610,-92660,0,-90462,2198
-2,2131,20190201,2159,315180,2111,2133,364906,2122,2139,414084,1526098.72,713502,-90462,0,-98904,-8442
59,2185,20190211,2191,340142,2117,2126,395940,2139,2163,425406,1363714.28,630412,-98904,0,-85264,13640
25,2208,20190212,2217,389502,2181,2183,458596,2163,2203,470278,2032387.63,922740,-85264,0,-80776,4488
-5,2204,20190213,2211,382356,2187,2209,447780,2203,2201,471066,1640480.43,745272,-80776,0,-88710,-7934
-6,2192,20190214,2211,376298,2183,2198,452574,2201,2196,484850,1737502.01,791148,-88710,0,-108552,-19842
-25,2163,20190215,2196,377934,2161,2188,442598,2196,2174,492350,1468885.94,675534,-108552,0,-114416,-5864
-6,2158,20190218,2175,380600,2151,2164,457244,2174,2164,510202,1154243.56,533438,-114416,0,-129602,-15186
-4,2154,20190219,2168,403848,2143,2158,485856,2164,2154,537728,1425880.03,661824,-129602,0,-133880,-4278
-40,2114,20190220,2157,436266,2104,2154,547582,2154,2129,605046,2089206.56,981392,-133880,0,-168780,-34900
6,2116,20190221,2128,422456,2107,2110,559350,2129,2119,587542,1183706.05,558720,-168780,0,-165086,3694
-8,2115,20190222,2134,440952,2107,2123,601318,2119,2122,621506,1475124.23,695220,-165086,0,-180554,-15468
-21,2098,20190225,2128,431376,2081,2119,634174,2122,2105,621908,1825902.25,867466,-180554,0,-190532,-9978
5,2108,20190226,2118,415076,2098,2103,626056,2105,2107,603340,1503885,713600,-190532,0,-188264,2268
-29,2074,20190227,2113,443558,2073,2103,680622,2107,2090,653000,1969754.11,942572,-188264,0,-209442,-21178
13,2079,20190228,2090,428702,2062,2066,657024,2090,2079,632996,1567305.51,753806,-209442,0,-204294,5148
92,2172,20190301,2181,622542,2078,2080,744516,2079,2150,663234,6716228.65,3124322,-204294,0,-40692,163602
-39,2146,20190304,2185,476838,2126,2185,632718,2150,2150,612178,4435366.52,2062676,-40692,0,-135340,-94648
12,2158,20190305,2189,494892,2144,2146,657250,2150,2166,619076,3732726.09,1723584,-135340,0,-124184,11156
13,2177,20190306,2194,494020,2153,2164,637050,2166,2173,614498,3320944.78,1528114,-124184,0,-120478,3706
-2,2180,20190307,2195,454996,2154,2182,564006,2173,2172,572448,2859993.59,1316592,-120478,1,-117452,3026
51,2236,20190308,2250,509882,2159,2185,632076,2172,2206,587610,5539207.62,2510992,-117452,0,-77728,39724
-10,2226,20190311,2255,461410,2211,2236,558858,2206,2233,540058,3756858.05,1682080,-77728,0,-78648,-920
-55,2173,20190312,2234,406564,2166,2228,482050,2233,2190,506334,3881623.09,1772646,-78648,0,-99770,-21122
-3,2170,20190313,2177,416934,2161,2173,485802,2190,2170,524254,2330808.15,1073942,-99770,0,-107320,-7550
9,2181,20190314,2194,389170,2140,2172,450930,2170,2173,499050,3170345.38,1458868,-107320,-1,-109880,-2560
14,2193,20190315,2196,400330,2164,2179,442946,2173,2180,491684,2235257.1,1025464,-109880,0,-91354,18526
23,2213,20190318,2230,391576,2188,2190,408300,2180,2214,454932,2947008.74,1330794,-91354,0,-63356,27998
5,2220,20190319,2235,390384,2203,2215,413314,2214,2220,456260,2100355.9,946192,-63356,-1,-65876,-2520
-12,2210,20190320,2237,392120,2201,2222,406412,2220,2218,460792,2021279.9,911348,-65876,0,-68672,-2796
-3,2208,20190321,2218,388542,2186,2211,396156,2218,2199,461958,2013566.88,915606,-68672,0,-73416,-4744
19,2230,20190322,2239,414344,2196,2211,426632,2199,2221,473756,2610504.11,1175324,-73416,0,-59412,14004
-14,2214,20190325,2242,386960,2208,2228,390110,2221,2222,461858,2069071.57,931028,-59412,0,-74898,-15486
1,2216,20190326,2227,378186,2212,2215,380140,2222,2218,452374,1144618.25,515958,-74898,0,-74188,710
14,2236,20190327,2248,428824,2219,2222,399898,2218,2235,474860,1841063.76,823810,-74188,0,-46036,28152
-59,2177,20190328,2239,399046,2170,2236,362654,2235,2208,494166,2118880.15,959808,-46036,0,-95120,-49084
-7,2180,20190329,2195,383004,2177,2187,349960,2203,2187,477816,513752.38,234942,-95120,1,-94812,308
0,2180,20190401,2197,375366,2168,2180,366570,2187,2181,478274,548834.25,251588,-94812,0,-102908,-8096
43,2224,20190402,2230,351000,2181,2181,359524,2181,2207,427806,857632.86,388604,-102908,0,-76806,26102
6,2230,20190403,2243,350612,2216,2224,383620,2207,2231,415398,950250.11,425924,-76806,0,-64786,12020
0,2231,20190404,2238,348088,2225,2231,392404,2231,2231,413078,682987.65,306098,-64786,0,-64990,-204
12,2237,20190408,2251,347452,2217,2225,413940,2231,2240,414198,719733.23,321298,-64990,-1,-66746,-1756
-30,2206,20190409,2241,342616,2197,2236,450326,2240,2215,427562,1256575.38,567288,-66746,0,-84946,-18200
0,2207,20190410,2213,344498,2202,2207,471576,2215,2208,435502,896388.08,406004,-84946,0,-91004,-6058
6,2215,20190411,2220,339666,2202,2209,483184,2208,2212,429800,1433331.56,648014,-91004,0,-90134,870
-18,2193,20190412,2214,349774,2188,2211,534630,2212,2197,441474,2049856.29,932906,-90134,0,-91700,-1566
33,2227,20190415,2232,334072,2191,2194,522098,2197,2214,425252,2004652.88,905380,-91700,0,-91180,520
-1,2231,20190416,2239,335888,2222,2232,526402,2214,2229,422742,2002418.41,898194,-91180,1,-86854,4326
-17,2214,20190417,2233,342202,2207,2231,528476,2229,2219,431754,1750470.53,788736,-86854,0,-89552,-2698
-4,2212,20190418,2222,343686,2198,2216,534208,2219,2211,435728,1543444.68,697982,-89552,0,-92042,-2490
17,2230,20190419,2239,356710,2208,2213,559264,2211,2225,444720,2166102.63,973376,-92042,0,-88010,4032
-2,2226,20190422,2248,350788,2209,2228,568106,2225,2226,446308,2468410.68,1108846,-88010,0,-95520,-7510
-7,2221,20190423,2233,348082,2212,2228,567244,2226,2223,453444,1574770.36,708458,-95520,0,-105362,-9842
-13,2210,20190424,2228,358982,2206,2223,592742,2223,2213,461554,1648804.19,744976,-105362,1,-102572,2790
-26,2181,20190425,2219,370094,2178,2207,619114,2213,2201,490796,2235294.13,1015724,-102572,0,-120702,-18130
-10,2172,20190426,2183,345418,2162,2182,604944,2201,2175,484488,1716710,789212,-120702,0,-139070,-18368
12,2185,20190429,2188,352528,2172,2173,594820,2175,2181,472846,1195272.23,547980,-139070,0,-120318,18752
-2,2183,20190430,2188,351056,2161,2185,581060,2181,2174,455258,1403263.09,645386,-120318,1,-104202,16116
4,2184,20190506,2211,309492,2170,2180,536988,2174,2190,427920,1353999.02,618188,-104202,-1,-118428,-14226
27,2209,20190507,2222,313632,2180,2182,528110,2190,2205,406752,2472264.23,1121352,-118428,0,-93120,25308
7,2215,20190508,2222,316618,2203,2208,533518,2205,2213,410728,1330897.85,601322,-93120,-1,-94110,-990
54,2270,20190509,2287,311318,2214,2216,517354,2213,2247,378298,3864406.76,1720054,-94110,0,-66980,27130
-14,2261,20190510,2290,300962,2243,2275,496086,2247,2265,374564,3123264.05,1379102,-66980,0,-73602,-6622
0,2267,20190513,2279,323650,2250,2267,539712,2265,2265,413396,2316163.53,1022612,-73602,0,-89746,-16144
-13,2261,20190514,2295,323396,2246,2274,519450,2265,2269,412592,2723016.73,1200086,-89746,1,-89196,550
21,2289,20190515,2298,338158,2259,2268,543896,2269,2277,426414,2246530.27,986606,-89196,0,-88256,940
37,2336,20190516,2354,380682,2291,2299,621240,2277,2330,463686,4673600.15,2006104,-88256,0,-83004,5252
-7,2335,20190517,2352,386828,2326,2342,609620,2330,2339,465248,2109090.61,901522,-83004,1,-78420,4584
23,2358,20190520,2366,412828,2326,2335,650404,2339,2348,499140,2378359.24,1012738,-78420,-1,-86312,-7892
57,2418,20190521,2428,449216,2353,2361,691846,2348,2400,534026,4380163.3,1825030,-86312,0,-84810,1502
-17,2407,20190522,2443,435472,2375,2424,645450,2400,2415,516634,3805829.22,1576112,-84810,1,-81162,3648
8,2412,20190523,2464,430170,2403,2404,640088,2415,2437,515696,4828405.9,1980886,-81162,-1,-85526,-4364
4,2417,20190524,2424,427554,2382,2413,635108,2437,2406,518112,2813856.16,1169382,-85526,-1,-90558,-5032
34,2460,20190527,2493,421134,2402,2426,630354,2406,2444,502048,4501367.97,1841932,-90558,0,-80914,9644
14,2478,20190528,2502,440820,2453,2464,652062,2444,2473,521314,4246648.76,1717196,-80914,0,-80494,420
112,2592,20190529,2597,487854,2454,2480,719904,2473,2543,540678,7547387.21,2968096,-80494,0,-52824,27670
-66,2510,20190530,2585,418938,2493,2576,609510,2543,2540,496314,6485552.67,2552930,-52824,0,-77376,-24552
-4,2519,20190531,2539,414316,2502,2523,587782,2540,2519,490862,3979859.02,1579666,-77376,1,-76546,830
